border_size=1
usage=map

Ww          , Ww          , Ww          , Ww          , Ww          , Ww          , Ds          , Gg          , Gg          , Gg          , Gg          , Gg          , Gg          , Gg          , Rd          , Rd          , Rd          , Gg          , Gs^Fms       , Gs^Fp       , Gs^Fp       , Gs^Fp       , Gs^Fp       , Gs^Fp       , Gs^Fp       , Gs^Fp       , Gs^Fp       , Gs^Fp       , Gs^Fp       , Gs^Fp       , Gs^Fp       , Gs^Fp       , Gs^Fp       , Gs^Fp       , Gs^Fp       , Gs^Fp       , Gs^Fp       , Gs^Fp       , Gs^Fp       , Gs^Fp       , Gs^Fp       , Gg          
Ww          , Ww          , Ww          , Ww          , Ww          , Ds          , Rd          , Gg          , Rd          , Gg          , Gs^Fms       , Gg          , Rd          , Gg          , Re          , Rd          , Dd^Dr       , Rd          , Rd          , Gs^Fms       , Gs^Fp       , Gs^Fp       , Gs^Fp       , Gs^Fp       , Gs^Fp       , Gs^Fp       , Gs^Fp       , Gs^Fp       , Gs^Fp       , Gs^Fp       , Gs^Fp       , Gs^Fp       , Gs^Fp       , Gs^Fp       , Gs^Fp       , Gs^Fp       , Gs^Fp       , Gs^Fp       , Gs^Fp       , Gs^Fp       , Gs^Fp       , Gs^Fp       
Ww          , Ww          , Ww          , Ww          , Ds          , Ds          , Dd^Vdt      , Rd          , Gg          , Gg          , Gs^Fms       , Rd          , Gg          , Re          , Gs^Fp       , Gs^Fp       , Gs^Fms       , Rd          , Rd          , Gg          , Gs^Fp       , Gs^Fp       , Gs^Fp       , Gs^Fp       , Cv          , Gs^Fp       , Gg^Ve       , Gs^Fp       , Gs^Fp       , Gs^Fp       , Gs^Fp       , Gs^Fp       , Gs^Fp       , Gg^Fet      , Gs^Fp       , Gs^Fp       , Gs^Fp       , Gs^Fp       , Gs^Fp       , Gs^Fp       , Gs^Fp       , Gs^Fp       
Ww          , Ww          , Ww          , Ww          , Ds          , Ds          , Rd          , Re          , Gg          , Gs^Fms       , Rd          , Gg          , Re          , Re          , Gs^Fp       , Gs^Fp       , Gs^Fms       , Gs^Fms       , Gs^Fp       , Rd          , Rd          , Gs^Fp       , Rd          , Cv          , 1 Kv        , Cv          , Gs^Fp       , Gs^Fp       , Gs^Fp       , Gs^Fp       , Gs^Fp       , Gs^Fp       , Gs^Fp       , Gs^Fp       , Gs^Fp       , Gs^Fp       , Gs^Fp       , Gs^Fp       , Gs^Fp       , Gs^Fp       , Gs^Fp       , Gs^Fp       
Ww          , Ww          , Ww          , Ds          , Ds          , Rd          , Rd          , Dd^Dr       , Gg          , Rd          , Re          , Re          , Gs^Fp       , Re          , Gs^Fp       , Gg^Ve       , Gs^Fms       , Gs^Fms       , Gs^Fms       , Gs^Fms       , Gs^Fp       , Rd          , Rd          , Cv          , Cv          , Cv          , Gs^Fp       , Gs^Fp       , Gs^Fp       , Gs^Fp       , Gs^Fp       , Gs^Fp       , Gs^Fp       , Gs^Fp       , Gs^Fp       , Gs^Fp       , Gs^Fp       , Gs^Fp       , Gs^Fp       , Gs^Fp       , Gs^Fp       , Gs^Fp       
Ww          , Ww          , Ww          , Ds          , Re          , Re          , Rd          , Re          , Gg          , Gg^Fet      , Re          , Re          , Gs^Fp       , Gs^Fp       , Gs^Fp       , Gs^Fms       , Gs^Fms       , Gs^Fms       , Gs^Fms       , Gs^Fms       , Gs^Fp       , Gs^Fp       , Gs^Fp       , Rd          , Gs^Fp       , Gg          , Gs^Fp       , Gs^Fp       , Gs^Fp       , Cv          , Gg^Ve       , Cv          , Gs^Fp       , Gs^Fp       , Gs^Fp       , Gs^Fp       , Gs^Fp       , Gs^Fp       , Gg^Ve       , Gs^Fp       , Gs^Fp       , Gs^Fp       
Ww          , Ww          , Ww          , Ds          , Rd          , Rd          , Rd          , Gg          , Gg          , Gs^Fp       , Re          , Gs^Fp       , Gs^Fms       , Gs^Fp       , Gs^Fms       , Gs^Fms       , Gs^Fms       , Gs^Fms       , Gs^Fp       , Gs^Fp       , Gs^Fp       , Gs^Fp       , Gs^Fp       , Gs^Fp       , Gs^Fp       , Gs^Fp       , Gs^Fp       , Cv          , Gg^Ve       , Gs^Fp       , Cv          , Gs^Fp       , Gg^Ve       , Cv          , Gs^Fp       , Gs^Fp       , Gs^Fp       , Gs^Fp       , Gs^Fp       , Gs^Fp       , Gs^Fp       , Gs^Fp       
Ww          , Ww          , Ch          , Ch          , Ch          , Gg          , Rd          , Gg          , Re          , Re          , Gs^Fms       , Gs^Fms       , Gs^Fms       , Gs^Fms       , Gs^Fp       , Gs^Fms       , Gs^Fms       , Gs^Fp       , Gs^Fp       , Gs^Fp       , Gs^Fp       , Gs^Fp       , Gs^Fp       , Gs^Fp       , Gs^Fp       , Gs^Fp       , Gs^Fp       , Gs^Fp       , Gs^Fp       , Cv          , 5 Kv        , Cv          , Gs^Fp       , Gs^Fp       , Gs^Fp       , Gs^Fp       , Gs^Fp       , Gs^Fp       , Gs^Fp       , Gs^Fp       , Gs^Fp       , Gs^Fp       
Ww          , Ww          , Ch          , 2 Kh        , Ch          , Gg          , Rd          , Gg          , Gg          , Gs^Fp       , Gs^Fp       , Gs^Fp       , Gs^Fms       , Gs^Fms       , Gs^Fms       , Gs^Fms       , Gs^Fms       , Gs^Fms       , Gs^Fp       , Gs^Fp       , Gs^Fp       , Gs^Fp       , Gs^Fp       , Gs^Fp       , Gs^Fp       , Gs^Fp       , Gs^Fp       , Cv          , Gg^Ve       , Cv          , Cv          , Cv          , Gg^Ve       , Cv          , Gs^Fp       , Gs^Fp       , Gs^Fp       , Gs^Fp       , Gs^Fp       , Gs^Fp       , Gs^Fp       , Gs^Fp       
Ds          , Ds          , Rd          , Ch          , Gg          , Gg          , Rd          , Gg^Vh       , Re          , Re          , Gs^Fms       , Re          , Re          , Gs^Fms       , Gs^Fms       , Gs^Fms       , Gs^Fms       , Gs^Fms       , Gs^Fp       , Gs^Fp       , Gs^Fp       , Gg^Ve       , Gs^Fp       , Gs^Fp       , Rd          , Gs^Fp       , Gs^Fp       , Gs^Fp       , Cv          , Gs^Fp       , Gg^Ve       , Gs^Fp       , Cv          , Gs^Fp       , Gg          , Gs^Fp       , Gs^Fp       , Gs^Fp       , Gs^Fp       , Gs^Fp       , Gs^Fp       , Gs^Fp       
Gg          , Rd          , Gg          , Rd          , Rd          , Rd          , Rd          , Rd          , Re          , Gs^Fms       , Gs^Fms       , Dd^Dr       , Gs^Fp       , Gs^Fms       , Gs^Fp       , Gs^Fp       , Gs^Fp       , Gs^Fp       , Gs^Fp       , Gs^Fp       , Gs^Fp       , Gs^Fp       , Gs^Fp       , Rd          , Rd          , Gs^Fp       , Gs^Fp       , Gs^Fp       , Gs^Fp       , Gs^Fp       , Cv          , Gs^Fp       , Gs^Fp       , Gs^Fp       , Gs^Fp       , Rd          , Rd          , Gg          , Gs^Fp       , Gg^Ve       , Gs^Fp       , Gs^Fp       
Gg          , Rd          , Rd          , Rd          , Rd          , Rd          , Re          , Re          , Gg          , Gs^Fp       , Gs^Fms       , Re          , Gs^Fp       , Gs^Fms       , Gs^Fp       , Gs^Fp       , Gs^Fp       , Gs^Fp       , Gs^Fp       , Gs^Fp       , Gs^Fms       , Gs^Fp       , Gs^Fp       , Rd          , Gs^Fp       , Gs^Fp       , Gs^Fp       , Gs^Fp       , Gs^Fp       , Gs^Fp       , Gs^Fp       , Gs^Fp       , Gs^Fp       , Gs^Fp       , Gs^Fp       , Gs^Fp       , Rd          , Gg          , Gs^Fp       , Gs^Fp       , Gs^Fp       , Gs^Fp       
Gg          , Gg          , Gg          , Rd          , Re          , Rd          , Dd^Dr       , Gg          , Gg          , Gs^Fp       , Gs^Fms       , Re          , Gs^Fms       , Gs^Fms       , Gs^Fp       , Gs^Fp       , Gs^Fp       , Gs^Fp       , Gs^Fms       , Gs^Fms       , Gs^Fp       , Gs^Fms       , Rd          , Rd          , Gs^Fp       , Gs^Fp       , Gs^Fp       , Gs^Fp       , Gs^Fp       , Gs^Fp       , Gs^Fp       , Gs^Fp       , Gs^Fp       , Gs^Fp       , Gs^Fp       , Gs^Fp       , Gs^Fp       , Rd          , Gs^Fp       , Gs^Fp       , Gs^Fp       , Gs^Fp       
Gg          , Gg          , Dd^Dr       , Re          , Re          , Rd          , Rd          , Gg          , Re          , Re          , Gs^Fms       , Gs^Fms       , Gs^Fms       , Gs^Fp       , Gg^Ve       , Gs^Fp       , Gs^Fp       , Gs^Fp       , Gs^Fms       , Gs^Fms       , Gs^Fp       , Gs^Fms       , Gg          , Rd          , Gs^Fp       , Gs^Fp       , Gg^Ve       , Gs^Fp       , Gs^Fp       , Gs^Fp       , Gs^Fp       , Gs^Fp       , Gs^Fp       , Gg^Fet      , Gs^Fp       , Gs^Fp       , Gs^Fp       , Gg          , Gs^Fp       , Gs^Fp       , Gs^Fp       , Gs^Fp       
Gg          , Re          , Re          , Gg          , Gg          , Re          , Rd          , Gg^Vh       , Re          , Gs^Fp       , Gs^Fms       , Gs^Fms       , Gs^Fp       , Gs^Fp       , Gs^Fp       , Gs^Fp       , Gs^Fp       , Gs^Fp       , Gs^Fp       , Gs^Fp       , Gs^Fp       , Gs^Fp       , Gg          , Gs^Fms       , Gs^Fms       , Gs^Fp       , Gs^Fp       , Gs^Fp       , Gs^Fp       , Gs^Fp       , Gs^Fp       , Gs^Fp       , Gs^Fp       , Gs^Fp       , Gs^Fp       , Gs^Fp       , Gs^Fp       , Gg          , Gg          , Gs^Fp       , Gs^Fp       , Gs^Fp       
Gg          , Gg          , Ch          , Re          , Gg          , Re          , Rd          , Rd          , Gg          , Gs^Fms       , Rd          , Gs^Fms       , Gs^Fms       , Gs^Fp       , Dd^Dr       , Gs^Fp       , Gs^Fp       , Gs^Fp       , Gg^Fet      , Gs^Fp       , Gs^Fp       , Gg          , Gs^Fms       , Gs^Fms       , Gs^Fms       , Gs^Fp       , Gs^Fms       , Gs^Fp       , Gs^Fp       , Gs^Fp       , Gs^Fp       , Gs^Fp       , Gs^Fp       , Gs^Fp       , Gs^Fp       , Gs^Fp       , Gg^Ve       , Gs^Fp       , Gg          , Gs^Fp       , Gs^Fp       , Gs^Fp       
Gg          , Ch          , 3 Kh        , Ch          , Rd          , Rd          , Rd          , Gg          , Gg          , Gg          , Rd          , Gs^Fp       , Gs^Fp       , Gs^Fp       , Gs^Fp       , Gs^Fp       , Rd          , Gs^Fp       , Re          , Re          , Re          , Gs^Fms       , Gs^Fp       , Gs^Fp       , Gs^Fms       , Gs^Fms       , Gs^Fms       , Gs^Fp       , Gs^Fp       , Gs^Fp       , Gs^Fms       , Gs^Fp       , Gs^Fms       , Gs^Fp       , Gs^Fp       , Gs^Fp       , Gs^Fp       , Gs^Fp       , Rd          , Gs^Fp       , Gs^Fp       , Gs^Fp       
Gg          , Ch          , Ch          , Ch          , Rd          , Rd          , Re          , Re          , Gg          , Gg          , Gs^Fp       , Gg^Fet      , Gs^Fp       , Gs^Fp       , Rd          , Rd          , Rd          , Gs^Fp       , Ch          , Gs^Fp       , Re          , Gs^Fms       , Gs^Fms       , Gs^Fms       , Gs^Fp       , Gs^Fms       , Gs^Fp       , Gs^Fp       , Gs^Fms       , Gs^Fp       , Gs^Fp       , Gs^Fms       , Gs^Fms       , Gs^Fp       , Gs^Fp       , Gs^Fp       , Gs^Fp       , Gs^Fp       , Rd          , Gg          , Gs^Fp       , Gs^Fp       
Gg          , Gg          , Gg          , Rd          , Gg          , Re          , Re          , Re          , Re          , Rd          , Rd          , Rd          , Gs^Fp       , Gs^Fp       , Rd          , Gs^Fp       , Gs^Fp       , Ch          , 4 Kh        , Ch          , Re          , Re          , Dd^Dr       , Re          , Gs^Fms       , Gs^Fms       , Gg^Ve       , Gs^Fp       , Gs^Fp       , Gs^Fms       , Gs^Fms       , Gs^Fp       , Gs^Fms       , Gs^Fms       , Gs^Fp       , Gs^Fp       , Gs^Fp       , Gg          , Rd          , Gs^Fp       , Gs^Fp       , Gs^Fp       
Rd          , Rd          , Rd          , Rd          , Rd          , Rd          , Re          , Gg          , Re          , Gg          , Dd^Dr       , Rd          , Rd          , Rd          , Gs^Fp       , Rd          , Gs^Fp       , Ch          , Ch          , Ch          , Re          , Re          , Re          , Re          , Gs^Fms       , Gs^Fms       , Gs^Fp       , Gs^Fp       , Gg^Fet      , Gs^Fp       , Gs^Fms       , Gs^Fms       , Gs^Fms       , Gs^Fms       , Gs^Fp       , Gs^Fp       , Gs^Fp       , Rd          , Rd          , Gs^Fp       , Gs^Fp       , Gs^Fp       
Rd          , Rd          , Gg          , Gg^Vh       , Rd          , Rd          , Rd          , Re          , Rd          , Re          , Re          , Rd          , Gs^Fp       , Rd          , Dd^Dr       , Rd          , Gs^Fp       , Gs^Fp       , Gs^Fp       , Gs^Fp       , Re          , Re          , Gs^Fp       , Gs^Fms       , Gs^Fp       , Gs^Fp       , Gs^Fp       , Gg^Ve       , Gs^Fp       , Gs^Fp       , Gs^Fms       , Gs^Fms       , Gs^Fms       , Gs^Fms       , Gs^Fp       , Gs^Fp       , Gs^Fp       , Rd          , Gg          , Gs^Fp       , Gg^Fet      , Gs^Fp       
Gg          , Rd          , Rd          , Dd^Dr       , Re          , Rd          , Gg          , Re          , Rd          , Gg          , Gg          , Gg          , Gg          , Gs^Fp       , Gs^Fp       , Gs^Fp       , Gs^Fp       , Gs^Fp       , Gs^Fp       , Re          , Gs^Fp       , Re          , Gs^Fp       , Gs^Fms       , Gs^Fp       , Gs^Fp       , Gs^Fp       , Gs^Fp       , Gs^Fp       , Gs^Fp       , Gs^Fp       , Gs^Fms       , Gs^Fp       , Gs^Fp       , Gs^Fp       , Gg^Ve       , Gs^Fp       , Rd          , Gs^Fp       , Gs^Fp       , Gs^Fp       , Gs^Fp       
Gg          , Gg          , Gg          , Rd          , Gg          , Re          , Re          , Re          , Rd          , Rd          , Rd          , Rd          , Gg          , Gg^Vh       , Gg          , Gs^Fp       , Gs^Fp       , Gs^Fp       , Gs^Fp       , Gs^Fp       , Gs^Fp       , Gs^Fp       , Gs^Fp       , Gs^Fp       , Gs^Fp       , Gs^Fp       , Gs^Fp       , Gs^Fp       , Gs^Fp       , Gs^Fp       , Gs^Fp       , Gs^Fp       , Gs^Fp       , Gs^Fp       , Gs^Fp       , Gs^Fp       , Gs^Fp       , Rd          , Gs^Fp       , Gs^Fp       , Gs^Fp       , Gs^Fp       
