border_size=1
usage=map

Mm          , Mm          , Mm          , Mm          , Mm          , Gg          , Mm          , Mm          , Xu          , Xu          , Rd          , Uu          , Re          , Uu          , Rd          , Xu          , Xu          , Uu          , Uu          , Uu          , Re          , Uu          , Uu          , Uu          , Rd          , Rd          , Xu          
Mm          , Mm          , Mm          , Mm          , Mm          , Mm          , Mm          , Mm          , Xu          , Xu          , Rd          , Re          , Re          , Uu          , Uu          , Xu          , Xu          , Uu^Uf       , Uu^Vud      , Uh          , Re          , Uu^Vud      , Rd          , Rd          , Xu          , Xu          , Xu          
Mm          , Mm          , Mm          , Mm          , Mm          , Mm          , Mm          , Mm          , Xu          , Xu          , Rd          , Uh          , Re          , Cud         , Uu          , Xu          , Uu^Vud      , Cud         , Cud         , Cud         , Uu^Vud      , Uu          , Xu          , Xu          , Xu          , Xu          , Uu          
Mm          , Mm          , Mm          , Mm          , Mm          , Mm          , Mm          , Mm          , Xu          , Xu          , Uh          , Rd          , Uu^Vud      , Re          , Re          , Uu          , Uu^Ii       , Cud         , 2 Kud       , Cud         , Uu^Ii       , Xu          , Xu          , Xu          , Uu^Uf       , Uu          , Re          
Mm          , Mm          , Mm          , Mm          , Mm          , Mm          , Mm          , Mm          , Xu          , Xu          , Xu          , Uu^Uf       , Uu          , Cud         , Uu          , Re          , Uu^Vud      , Cud         , Cud         , Cud         , Uu^Vud      , Xu          , Uu          , Uu          , Re^Uf       , Re          , Uh          
Mm          , Mm          , Mm          , Mm          , Mm          , Mm          , Mm          , Mm          , Mm          , Xu          , Xu          , Xu          , Xu          , Uu^Ii       , Uu^Ii       , Uu          , Rd          , Uu^Ii       , Uu^Vud      , Uu^Ii       , Uu          , Uu          , Cud         , Re          , Uh          , Uh          , Rd          
Mm          , Mm          , Mm          , Mm          , Mm          , Mm          , Mm          , Mm          , Mm          , Mm          , Mm          , Xu          , Uu          , Cud         , Uu^Ii       , Uu^Ufi      , Re          , Re          , Uu          , Uu          , Cud         , Uu^Uf       , Uu^Uf       , Uu^Vud      , Rd          , Rd          , Uh          
Mm          , Mm          , Gs          , Ds          , Ds          , Mm          , Mm          , Mm          , Hh          , Mm          , Hh^Vhh      , Hh          , Hh          , Hh          , Hh          , Re          , Uu^Ii       , Uu^Ii       , Uh^Ii       , Uh          , Uu^Vud      , Uu          , Rd          , Uh          , Uh          , Rd          , Xu          
Gs          , Gs          , Gs          , Ds          , Hh          , Hh          , Hh          , Hh          , Hh          , Hh          , Hh          , Hh          , Hh          , Hh          , Rd          , Hh          , Hh          , Cud         , Xu          , Xu          , Xu          , Rd          , Rd          , Rd          , Xu          , Xu          , Xu          
Gs          , Gs          , Gs          , Ds          , Hh          , Hh          , Hh          , Hh          , Hh          , Hh          , Hh          , Hh          , Gs          , Gs          , Rd          , Gs          , Gs          , Gs          , Hh          , Xu          , Xu          , Xu          , Xu          , Xu          , Xu          , Xu          , Mm          
Gs          , Gs          , Hh          , Hh          , Hh          , Hh          , Hh          , Hh          , Hh          , Hh          , Gs          , Gs          , Hh          , Hh          , Rd          , Hh          , Hh          , Gs          , Hh          , Hh          , Mm          , Xu          , Xu          , Xu          , Mm          , Mm          , Mm          
Hh          , Hh          , Hh          , Hh          , Hh          , Hh          , Hh          , Hh          , Hh          , Hh          , Hh          , Hh          , Rd          , Rd          , Gs          , Hh          , Gs          , Gs          , Ds          , Hh^Vhh      , Hh          , Mm          , Mm          , Mm          , Mm          , Mm          , Mm          
Hh          , Hh          , Hh          , Hh          , Hh          , Hh          , Hh          , Hh          , Hh          , Hh          , Ds          , Ds          , Rd          , Gs          , Hh          , Gs          , Hh          , Gs^Vht      , Ds          , Ds          , Hh          , Mm          , Mm          , Mm          , Mm          , Mm          , Mm          
Hh          , Hh          , Hh^Vhh      , Hh          , Hh          , Hh          , Hh          , Hh          , Hh          , Hh          , Gs          , Ds          , Rd          , Hh          , Hh          , Hh          , Hh          , Hh          , Ds          , Hh          , Hh          , Mm          , Mm          , Mm          , Mm          , Mm          , Mm          
Hh          , Hh          , Hh          , Hh          , Hh          , Hh          , Hh          , Gs^Vht      , Hh          , Hh          , Hh          , Hh          , Gs          , Gs          , Gs          , Hh          , Hh          , Hh          , Hh          , Gs          , Hh          , Mm          , Mm          , Mm          , Mm          , Mm          , Mm          
Hh          , Hh          , Hh          , Hh          , Gs          , Gs          , Gs          , Gs          , Hh          , Hh          , Gs          , Gs          , Rd          , Hh          , Hh          , Hh          , Hh          , Hh          , Hh          , Gs          , Gs          , Hh          , Hh          , Mm          , Hh          , Mm          , Hh          
Hh          , Hh          , Hh          , Gs          , Hh          , Hh          , Hh          , Ds          , Ds          , Hh          , Gs          , Rd          , Hh          , Hh          , Hh          , Hh          , Hh          , Hh          , Hh          , Hh          , Gs          , Gs          , Gs^Vht      , Hh          , Hh          , Hh          , Hh          
Hh          , Hh          , Gs          , Gs          , Hh          , Gs          , Gs          , Hh          , Hh          , Ds          , Rd          , Rd          , Hh          , Hh          , Gs          , Hh          , Hh          , Hh          , Hh          , Hh          , Hh          , Hh          , Hh          , Hh          , Hh          , Hh          , Hh          
Hh          , Gs          , Hh          , Hh          , Hh          , Hh          , Hh          , Gs          , Gs          , Hh          , Rd          , Hh          , Hh          , Gs          , Hh          , Hh          , Hh          , Hh          , Gs^Vht      , Hh          , Ce          , Hh          , Hh          , Hh          , Hh          , Hh^Vhh      , Hh          
Gs          , Gs          , Hh          , Hh          , Hh          , Hh          , Hh          , Gs          , Hh          , Hh          , Gs          , Hh          , Hh          , Hh          , Hh          , Hh          , Hh          , Hh          , Hh          , Gs          , Ce          , Ke          , Hh          , Hh          , Hh          , Hh          , Hh          
Gs          , Gs          , Gs          , Gs          , Gs          , Hh          , Hh          , Gs          , Gs          , Gs          , Gs          , Gs          , Hh          , Hh          , Hh          , Hh          , Hh          , Hh          , Hh          , Hh          , Hh          , Hh          , Ds          , Hh          , Hh^Vhh      , Hh          , Hh          
Hh          , Gs          , Hh          , Gs          , Hh          , Hh          , Hh          , Hh          , Hh          , Rd          , Gs          , Ds          , Gs          , Hh          , Hh          , Hh          , Hh          , Hh          , Hh          , Hh          , Hh          , Hh          , Ds          , Gs          , Hh          , Hh          , Hh          
Hh          , Gs          , Hh          , Hh          , Hh          , Hh^Vhh      , Hh          , Hh          , Hh          , Rd          , Hh          , Ds          , Gs          , Hh          , Hh          , Hh          , Hh          , Hh          , Hh          , Hh          , Gs          , Hh          , Gs^Vht      , Gs          , Gs          , Hh          , Hh          
Hh          , Gs          , Gs          , Hh          , Hh          , Hh          , Hh          , Hh          , Hh          , Rd          , Hh          , Hh          , Gs          , Gs          , Hh          , Hh          , Hh          , Hh          , Hh          , Hh          , Gs          , Gs          , Hh          , Hh          , Gs          , Hh          , Hh          
Hh          , Hh          , Hh          , Gs          , Ds          , Hh          , Hh          , Hh          , Gs          , Rd          , Gs          , Hh          , Ds          , Hh          , Hh          , Hh          , Hh          , Hh          , Hh          , Gs          , Gs          , Hh          , Hh          , Gs          , Hh          , Hh          , Hh          
Hh^Vhh      , Hh          , Hh          , Hh          , Hh          , Ds          , Hh          , Gs          , Rd          , Gs          , Hh          , Hh          , Ds          , Hh          , Hh          , Hh          , Hh          , Hh          , Gs          , Hh          , Gs          , Hh          , Hh          , Gs          , Hh          , Hh          , Hh          
Hh          , Hh          , Hh          , Hh          , Hh          , Hh          , Ss          , Hh          , Rd          , Hh          , Gs          , Ds          , Hh          , Hh          , Hh          , Hh          , Hh          , Hh          , Gs          , Hh          , Hh          , Hh          , Hh          , Gs          , Hh          , Hh          , Hh          
Hh          , Hh          , Hh          , Hh          , Hh          , Ss          , Ss          , Ss          , Hh          , Rd          , Hh          , Hh          , Hh          , Hh          , Hh          , Hh          , Hh          , Gs          , Gs^Vht      , Gs          , Hh          , Hh          , Gs          , Hh          , Hh          , Hh          , Hh          
Hh          , Hh          , Chr         , Chs         , Chs         , Ss          , Ss          , Ss          , Gs          , Rd          , Rd          , Hh          , Ss          , Hh          , Hh          , Hh          , Hh          , Hh          , Hh          , Hh          , Gs          , Gs          , Gs          , Gs          , Gs          , Gs          , Gs          
Hh          , Hh          , Chr         , Khs         , Chs         , Ss          , Ss          , Hh          , Gs          , Hh          , Hh          , Hh          , Hh          , Ss          , Hh          , Hh          , Ss          , Hh          , Gs          , Gs          , Hh          , Gs          , Hh          , Hh          , Hh          , Hh          , Hh          
Hh          , Hh          , Hh          , Chs         , Gs          , Ss          , Ss          , Ss          , Hh          , Hh^Vhh      , Hh          , Hh          , Rd          , Gs          , Hh          , Ss          , Ss          , Gs          , Hh          , Hh          , Hh          , Dd^Vdt      , Hh          , Hh          , Hh          , Hh          , Hh          
Hh          , Hh          , Hh          , Ss          , Gs          , Gs          , Hh          , Hh          , Ss          , Hh          , Hh          , Ss          , Ss          , Rd          , Rd          , Ss          , Hh          , Hh          , Hh          , Hh          , Hh          , Ds          , Ds          , Hh          , Gs          , Hh          , Gs          
Gs          , Hh          , Hh          , Hh          , Ss          , Gs          , Ss          , Ss          , Hh          , Ss          , Ss          , Ss          , Hh          , Hh          , Gs          , Rd          , Rd          , Hh          , Hh          , Hh          , Ds          , Hh          , Ss          , Ds          , Ds          , Ds          , Wo          
Gs          , Gs          , Gs          , Hh          , Ss          , Ds          , Ss          , Ss          , Ss          , Ss          , Ds          , Hh          , Hh          , Gs          , Gs          , Hh          , Hh          , Rd          , Hh          , Hh          , Ww          , Ss          , Wo          , Ww          , Wo          , Wo          , Ss          
Gs          , Gs          , Ss          , Ds          , Ss          , Ss          , Hh          , Ds          , Ss          , Ds          , Ww          , Hh^Vhh      , Ww          , Ds          , Ds          , Gs          , Hh          , Hh          , Wwf         , Chw         , Ww          , Wo          , Wo          , Wo          , Ss          , Ss          , Ss          
Hh          , Ss          , Ss          , Ss          , Hh          , Ss          , Ww          , Ss          , Wo          , Ww          , Wo          , Wo          , Wo          , Wo          , Wo          , Ww          , Chw         , Wwf         , Rd          , Hh          , Ds          , Ww          , Ds          , Ss          , Hh          , Ss^Vhs      , Hh          
Hh          , Ds          , Ww          , Ww          , Ww          , Ww          , Wo          , Wo          , Wo          , Ww          , Ss          , Ss^Vm       , Ss          , Ww          , Ww          , Ww          , Hh          , Hh          , Rd          , Hh          , Hh          , Ds          , Gs          , Hh          , Hh          , Hh          , Hh          
Ww          , Ww          , Wo          , Wo          , Ww          , Ww          , Ww          , Ww          , Hh          , Hh          , Hh          , Ss          , Hh          , Ds          , Ds          , Ds          , Gs          , Hh          , Rd          , Hh          , Hh          , Hh          , Hh          , Gs          , Gs          , Hh          , Hh          
Ww          , Wo          , Ww          , Ww          , Ss          , Ss          , Ds          , Ds          , Gs          , Gs          , Gs          , Hh          , Hh          , Hh          , Hh          , Hh          , Hh          , Gs          , Gs          , Hh          , Hh          , Hh          , Hh          , Hh          , Gs          , Hh          , Hh          
Ww          , Ww          , Ds          , Ds          , Gs          , Gs          , Hh          , Gs          , Hh          , Hh          , Hh          , Gs          , Gs          , Hh          , Gs          , Hh          , Rd          , Rd          , Hh          , Hh          , Hh          , Hh          , Ds          , Hh          , Hh          , Gs          , Hh          
Hh          , Hh          , Hh          , Hh          , Gs          , Gs          , Gs          , Gs          , Gs          , Hh          , Gs          , Hh          , Gs          , Gs          , Gs          , Gs          , Rd          , Hh          , Hh          , Hh          , Ds          , Ds          , Hh          , Gs          , Hh          , Gs          , Hh          
Hh          , Hh          , Hh          , Hh          , Gs          , Gs          , Gs          , Hh          , Hh          , Gs          , Gs          , Gs          , Gs          , Hh          , Gs          , Gs^Vht      , Rd          , Hh          , Hh          , Gs          , Hh          , Hh          , Gs          , Gs          , Hh          , Gs          , Hh          
Hh          , Hh          , Hh          , Gs          , Hh          , Hh          , Hh          , Gs          , Gs          , Gs          , Hh          , Hh          , Gs          , Ds          , Ds          , Rd          , Gs          , Hh          , Hh          , Gs          , Hh          , Hh          , Gs          , Hh          , Gs          , Gs          , Hh          
Hh          , Hh          , Hh          , Gs          , Hh          , Hh          , Hh          , Hh          , Hh          , Gs          , Gs          , Hh          , Hh          , Ds          , Ds          , Gs          , Gs          , Hh          , Hh          , Hh          , Gs          , Gs          , Gs          , Hh          , Gs          , Hh          , Hh          
Hh          , Hh          , Hh          , Hh          , Hh          , Hh          , Hh          , Hh          , Gs          , Gs          , Gs          , Gs          , Ds          , Hh          , Hh          , Rd          , Hh          , Hh          , Hh          , Hh          , Gs          , Hh          , Ds          , Ds          , Hh          , Hh          , Hh          
Hh          , Hh          , Hh          , Gs          , Gs          , Gs          , Gs          , Hh          , Gs          , Gs          , Hh          , Hh          , Hh          , Ds          , Gs          , Rd          , Hh          , Hh          , Gs          , Hh          , Gs          , Gs          , Hh          , Hh          , Hh          , Hh          , Hh          
Hh          , Hh          , Gs^Fms       , Gs^Fms       , Gs^Fms       , Gs          , Gs          , Gs          , Gs          , Hh          , Gs^Fms       , Hh          , Hh          , Hh          , Hh          , Rd          , Hh          , Gs          , Gs          , Hh          , Gs          , Hh          , Gs          , Gs          , Gs          , Hh          , Hh          
Hh          , Gs^Fms       , Hh          , Gs^Fms       , Gs^Fms       , Gs^Fms       , Gs^Fms       , Gs^Fms       , Gs^Fms       , Gs^Fms       , Gs^Fp       , Gs^Fp       , Cv          , Cv          , Cv          , Gs^Fms       , Gs^Fp       , Hh          , Hh          , Gs          , Hh          , Gs          , Gs          , Gs          , Gs          , Hh          , Hh          
Hh          , Hh          , Gs^Fp       , Gs^Fp       , Gs^Fp       , Gs^Fp       , Gs^Fp       , Gs^Fp       , Gg^Ve       , Gs^Fp       , Gs^Fms       , Gs^Fp       , Cv          , 1 Kv        , Cv          , Gs^Fms       , Gs^Fms       , Gs^Fms       , Gs^Fms       , Gs^Fms       , Gs          , Gs^Fms       , Hh          , Gs          , Hh          , Hh          , Hh          
Gs^Fp       , Gs^Fp       , Gs^Fp       , Gs^Fms       , Gs^Fp       , Gs^Fp       , Gs^Fp       , Gs^Fp       , Gs^Fp       , Gs^Fp       , Gs^Fp       , Gs^Fp       , Gs^Fp       , Cv          , Gs^Fp       , Gs^Fms       , Gs^Fp       , Gs^Fp       , Gs^Fp       , Gs^Fp       , Gs^Fms       , Gs          , Gs          , Gs          , Gs^Fp       , Hh          , Hh          
Gs^Fp       , Gs^Fp       , Gg^Ve       , Gs^Fp       , Gs^Fp       , Gs^Fp       , Gs^Fp       , Gs^Fp       , Gs^Fp       , Gs^Fp       , Gs^Fp       , Gs^Fms       , Gs^Fp       , Gs^Fp       , Gs^Fp       , Gs^Fp       , Gs^Fp       , Gs^Fp       , Gg^Ve       , Gs^Fp       , Gs^Fp       , Gs^Fms       , Gs^Fp       , Gs^Fp       , Gs^Fp       , Gs^Fp       , Hh          
Gs^Fp       , Gs^Fp       , Gs^Fp       , Gs^Fp       , Gs^Fp       , Gs^Fp       , Gs^Fp       , Gs^Fp       , Gs^Fp       , Gs^Fp       , Gs^Fp       , Gs^Fp       , Gs^Fp       , Gs^Fp       , Gg^Ve       , Gs^Fp       , Gs^Fp       , Gs^Fp       , Gs^Fp       , Gs^Fp       , Gs^Fp       , Gs^Fp       , Gs^Fp       , Gg^Ve       , Gs^Fp       , Gs^Fp       , Hh          
Gs^Fp       , Gs^Fp       , Gs^Fp       , Gs^Fp       , Gg          , Gs^Fp       , Gg          , Gs^Fp       , Gs^Fp       , Gs^Fp       , Gs^Fp       , Gs^Fp       , Gs^Fp       , Gs^Fp       , Gs^Fp       , Gs^Fp       , Gs^Fp       , Gs^Fp       , Gs^Fp       , Gs^Fp       , Gs^Fp       , Gs^Fp       , Gs^Fp       , Gs^Fp       , Gs^Fp       , Gs^Fp       , Hh          
