Md, Md, Md, Md, Md, Gg, Md, Md, Xu, Xu, Rd, Uu, Re, Uu, Rd, Xu, Xu, Uu, Uu, Uu, Re, Uu, Uu, Uu, Rd, Rd, Xu
Md, Md, Md, Md, Md, Md, Md, Md, Xu, Xu, Rd, Re, Re, Uu, Uu, Xu, Xu, Uu^Tf, Uu^Vud, Uh, Re, Uu^Vud, Rd, Rd, Xu, Xu, Xu
Md, Md, Md, Md, Md, Md, Md, Md, Xu, Xu, Rd, Uh, Re, Cud, Uu, Xu, Uu^Vud, Cud, Cud, Cud, Uu^Vud, Uu, Xu, Xu, Xu, Xu, Uu
Md, Md, Md, Md, Md, Md, Md, Md, Xu, Xu, Uh, Rd, Uu^Vud, Re, Re, Uu, Uu^Ii, Cud, 2 Kud, Cud, Uu^Ii, Xu, Xu, Xu, Uu^Tf, Uu, Re
Md, Md, Md, Md, Md^Xm, Md, Md, Md, Xu, Xu, Xu, Uu^Tf, Uu, Cud, Uu, Re, Uu^Vud, Cud, Cud, Cud, Uu^Vud, Xu, Uu, Uu, Uu^Tf, Re, Uh
Md, Md, Md^Xm, Md^Xm, Md, Md^Xm, Md^Xm, Md^Xm, Md^Xm, Xu, Xu, Xu, Xu, Uu^Ii, Uu^Ii, Uu, Rd, Uu^Ii, Uu^Vud, Uu^Ii, Uu, Uu, Cud, Re, Uh, Uh, Rd
Md^Xm, Md^Xm, Md, Md, Md, Md, Md, Md, Md, Md^Xm, Md, Xu, Uu, Cud, Uu^Ii, Uu^Tfi, Re, Re, Uu, Uu, Cud, Uu^Tf, Uu^Tf, Uu^Vud, Rd, Rd, Uh
Md, Md, Gd, Ds, Ds, Md, Md, Md, Hh, Md, Hh^Vhh, Hh, Hh, Hh, Hh, Re, Uu^Ii, Uu^Ii, Uh^Ii, Uh, Uu^Vud, Uu, Rd, Uh, Uh, Rd, Xu
Gd, Gd, Gs, Ds, Hh, Hh, Hhd, Hh, Hhd, Hh, Hh, Hh, Hhd, Hhd, Rd, Hh, Hh, Cud, Xu, Xu, Xu, Rd, Rd, Rd, Xu, Xu, Xu
Gd, Gd, Gd, Ds, Hh, Hh, Hhd, Hh, Hh, Hh, Hh, Hh, Gs, Gd, Rd, Gs, Gs, Gs, Hh, Xu, Xu, Xu, Xu, Xu, Xu, Xu, Md
Gs, Gd, Hh, Hh, Hh, Hh, Hh, Hh, Hh, Hh, Gs, Gd, Hhd, Hh, Rd, Hh, Hhd, Gs, Hhd, Hhd, Md, Xu, Xu, Xu, Md, Md, Md
Hh, Hh, Hh, Hhd, Hh, Hh, Hh, Hh, Hh, Hhd, Hh, Hh, Rd, Rd, Gs, Hh, Gs, Gs, Ds, Hh^Vhh, Hh, Md, Md^Xm, Md, Md, Md, Md
Hh, Hhd, Hh, Hh, Hh, Hh, Hh, Hhd, Hhd, Hh, Ds, Ds, Rd, Gd, Hh, Gd, Hh, Gs^Vht, Ds, Ds, Hh, Md, Md^Xm, Md, Md, Md, Md
Hh, Hhd, Hh^Vhh, Hh, Hhd, Hh, Hh, Hh, Hh, Hhd, Gs, Ds, Rd, Hh, Hh, Hh, Hhd, Hh, Ds, Hh, Hhd, Md, Md, Md^Xm, Md^Xm, Md, Md^Xm
Hhd, Hh, Hhd, Hh, Hh, Hh, Hh, Gs^Vht, Hh, Hhd, Hh, Hhd, Gd, Gs, Gd, Hh, Hh, Hh, Hh, Gs, Hh, Md, Md, Md, Md, Md^Xm, Md
Hhd, Hhd, Hh, Hh, Gs, Gd, Gd, Gs, Hhd, Hh, Gs, Gd, Rd, Hh, Hh, Hh, Hhd, Hh, Hh, Gs, Gd, Hh, Hh, Md, Hh, Md, Hh
Hh, Hhd, Hh, Gs, Hh, Hh, Hh, Ds, Ds, Hh, Gs, Rd, Hh, Hh, Hhd, Hh, Hh, Hh, Hh, Hh, Gs, Gd, Gs^Vht, Hh, Hh, Hhd, Hh
Hhd, Hh, Gd, Gs, Hh, Gs, Gd, Hh, Hh, Ds, Rd, Rd, Hhd, Hh, Gd, Hh, Hh, Hh, Hhd, Hh, Hhd, Hh, Hhd, Hh, Hh, Hh, Hhd
Hhd, Gs, Hh, Hh, Hh, Hh, Hhd, Gd, Gs, Hhd, Rd, Hh, Hh, Gd, Hhd, Hh, Hh, Hhd, Gs^Vht, Hhd, Co, Hh, Hhd, Hh, Hh, Hh^Vhh, Hhd
Gd, Gd, Hh, Hh, Hh, Hh, Hh, Gs, Hhd, Hh, Gs, Hh, Hh, Hh, Hh, Hh, Hh, Hhd, Hh, Gs, Co, Ko, Hh, Hh, Hhd, Hh, Hhd
Gs, Gs, Gd, Gs, Gs, Hh, Hh, Gd, Gs, Gs, Gd, Gs, Hh, Hh, Hh, Hhd, Hhd, Hhd, Hhd, Hh, Hh, Hh, Ds, Hh, Hh^Vhh, Hh, Hh
Hh, Gs, Hhd, Gs, Hhd, Hhd, Hh, Hh, Hh, Rd, Gd, Ds, Gs, Hh, Hh, Hh, Hh, Hhd, Hh, Hh, Hhd, Hh, Ds, Gd, Hhd, Hhd, Hh
Hh, Gs, Hh, Hh, Hh, Hh^Vhh, Hh, Hh, Hh, Rd, Hh, Ds, Gd, Hh, Hh, Hhd, Hhd, Hhd, Hh, Hhd, Gs, Hh, Gs^Vht, Gd, Gs, Hh, Hh
Hh, Gs, Gd, Hhd, Hh, Hh, Hhd, Hh, Hh, Rd, Hh, Hhd, Gs, Gs, Hhd, Hhd, Hh, Hhd, Hhd, Hh, Gs, Gd, Hh, Hhd, Gs, Hh, Hh
Hh, Hh, Hhd, Gs, Ds, Hhd, Hh, Hh, Gd, Rd, Gd, Hhd, Ds, Hhd, Hhd, Hh, Hh, Hh, Hh, Gs, Gd, Hh, Hh, Gs, Hhd, Hh, Hh
Hh^Vhh, Hh, Hh, Hh, Hhd, Ds, Hh, Gd, Rd, Gd, Hhd, Hh, Ds, Hh, Hh, Hh, Hhd, Hh, Gd, Hhd, Gs, Hh, Hhd, Gd, Hhd, Hh, Hh
Hhd, Hhd, Hh, Hhd, Hh, Hh, Ss, Hhd, Rd, Hhd, Gd, Ds, Hh, Hh, Hhd, Hh, Hhd, Hh, Gs, Hhd, Hhd, Hhd, Hh, Gs, Hh, Hh, Hhd
Hh, Hh, Hh, Hh, Hh, Ss, Ss, Ss, Hhd, Rd, Hh, Hh, Hh, Hh, Hh, Hh, Hhd, Gs, Gs^Vht, Gs, Hh, Hhd, Gd, Hh, Hh, Hh, Hh
Hh, Hh, Chr, Chs, Chs, Ss, Ss, Ss, Gs, Rd, Rd, Hhd, Ss, Hh, Hh, Hh, Hhd, Hh, Hh, Hhd, Gs, Gd, Gs, Gs, Gs, Gs, Gd
Hhd, Hh, Chr, Khs, Chs, Ss, Ss, Hh, Gd, Hh, Hh, Hh, Hhd, Ss, Hh, Hh, Ss, Hh, Gd, Gs, Hh, Gs, Hh, Hhd, Hh, Hh, Hhd
Hh, Hh, Hh, Chs, Gs, Ss, Ss, Ss, Hh, Hh^Vhh, Hhd, Hhd, Rd, Gs, Hh, Ss, Ss, Gs, Hh, Hh, Hh, Dd^Vdt, Hh, Hh, Hhd, Hhd, Hh
Hh, Hh, Hh, Ss, Gd, Gd, Hh, Hh, Ss, Hh, Hh, Ss, Ss, Rd, Rd, Ss, Hh, Hh, Hh, Hh, Hh, Ds, Ds, Hh, Gs, Hh, Gs
Gs, Hh, Hh, Hhd, Ss, Gs, Ss, Ss, Hh, Ss, Ss, Ss, Hh, Hh, Gs, Rd, Rd, Hh, Hhd, Hhd, Ds, Hhd, Ss, Ds, Ds, Ds, Wo
Gd, Gs, Gs, Hh, Ss, Ds, Ss, Ss, Ss, Ss, Ds, Hh, Hhd, Gd, Gd, Hh, Hhd, Rd, Hh, Hhd, Ww, Ss, Wo, Ww, Wo, Wo, Ss
Gd, Gs, Ss, Ds, Ss, Ss, Hh, Ds, Ss, Ds, Ww, Hh^Vhh, Ww, Ds, Ds, Gs, Hh, Hh, Wwf, Chw, Ww, Wo, Wo, Wo, Ss, Ss, Ss
Hh, Ss, Ss, Ss, Hh, Ss, Ww, Ss, Wo, Ww, Wo, Wo, Wo, Wo, Wo, Ww, Chw, Wwf, Rd, Hh, Ds, Ww, Ds, Ss, Hh, Ss^Vhs, Hhd
Hh, Ds, Ww, Ww, Ww, Ww, Wo, Wo, Wo, Ww, Ss, Ss^Vm, Ss, Ww, Ww, Ww, Hh, Hh, Rd, Hh, Hhd, Ds, Gd, Hhd, Hh, Hh, Hh
Ww, Ww, Wo, Wo, Ww, Ww, Ww, Ww, Hh, Hhd, Hh, Ss, Hhd, Ds, Ds, Ds, Gs, Hh, Rd, Hh, Hh, Hh, Hh, Gd, Gd, Hhd, Hh
Ww, Wo, Ww, Ww, Ss, Ss, Ds, Ds, Gs, Gs, Gs, Hh, Hh, Hh, Hh, Hhd, Hhd, Gs, Gs, Hhd, Hh, Hhd, Hh, Hh, Gs, Hhd, Hh
Ww, Ww, Ds, Ds, Gs, Gs, Hh, Gd, Hh, Hh, Hh, Gs, Gs, Hh, Gd, Hhd, Rd, Rd, Hh, Hh, Hh, Hh, Ds, Hhd, Hh, Gs, Hh
Hhd, Hh, Hhd, Hhd, Gd, Gs, Gs, Gs, Gd, Hh, Gs, Hh, Gs, Gs, Gd, Gd, Rd, Hh, Hh, Hh, Ds, Ds, Hhd, Gs, Hhd, Gs, Hh
Hhd, Hhd, Hh, Hh, Gd, Gd, Gd, Hh, Hh, Gs, Gs, Gd, Gs, Hhd, Gs, Gs^Vht, Rd, Hhd, Hh, Gs, Hh, Hh, Gs, Gs, Hh, Gd, Hh
Hh, Hh, Hh, Gs, Hh, Hh, Hh, Gd, Gd, Gs, Hhd, Hhd, Gd, Ds, Ds, Rd, Gs, Hhd, Hhd, Gd, Hh, Hhd, Gs, Hh, Gs, Gd, Hh
Hh, Hhd, Hh, Gs, Hh, Hh, Hh, Hh, Hh, Gs, Gs, Hh, Hh, Ds, Ds, Gs, Gd, Hhd, Hh, Hhd, Gs, Gd, Gs, Hh, Gd, Hh, Hhd
Hhd, Hhd, Hh, Hh, Hh, Hh, Hhd, Hh, Gs, Gs, Gd, Gs, Ds, Hhd, Hhd, Rd, Hh, Hhd, Hh, Hh, Gs, Hh, Ds, Ds, Hh, Hh, Hh
Hhd, Hh, Hhd, Gs, Gs, Gd, Gs, Hh, Gs, Gs, Hh, Hh, Hhd, Ds, Gs, Rd, Hhd, Hh, Gs, Hhd, Gs, Gs, Hhd, Hh, Hh, Hhd, Hh
Hh, Hh, Gs^Fms, Gs^Fms, Gs^Fms, Gd, Gd, Gs, Gs, Hh, Gs^Fms, Hh, Hh, Hh, Hh, Rd, Hhd, Gs, Gd, Hhd, Gs, Hhd, Gd, Gs, Gd, Hh, Hhd
Hhd, Gs^Fms, Hh, Gs^Fms, Gs^Fms, Gs^Fms, Gs^Fms, Gs^Fms, Gs^Fms, Gs^Fms, Gs^Fp, Gs^Fp, Cv, Cv, Cv, Gs^Fms, Gs^Fp, Hh, Hhd, Gd, Hh, Gs, Gs, Gs, Gs, Hh, Hhd
Hh, Hh, Gs^Fp, Gs^Fp, Gs^Fp, Gs^Fp, Gs^Fp, Gs^Fp, Gg^Ve, Gs^Fp, Gs^Fms, Gs^Fp, Cv, 1 Kv, Cv, Gs^Fms, Gs^Fms, Gs^Fms, Gs^Fms, Gs^Fms, Gs, Gs^Fms, Hh, Gs, Hh, Hhd, Hh
Gs^Fp, Gs^Fp, Gs^Fp, Gs^Fms, Gs^Fp, Gs^Fp, Gs^Fp, Gs^Fp, Gs^Fp, Gs^Fp, Gs^Fp, Gs^Fp, Gs^Fp, Cv, Gs^Fp, Gs^Fms, Gs^Fp, Gs^Fp, Gs^Fp, Gs^Fp, Gs^Fms, Gd, Gd, Gd, Gs^Fp, Hhd, Hh
Gs^Fp, Gs^Fp, Gg^Ve, Gs^Fp, Gs^Fp, Gs^Fp, Gs^Fp, Gs^Fp, Gs^Fp, Gs^Fp, Gs^Fp, Gs^Fms, Gs^Fp, Gs^Fp, Gs^Fp, Gs^Fp, Gs^Fp, Gs^Fp, Gg^Ve, Gs^Fp, Gs^Fp, Gs^Fms, Gs^Fp, Gs^Fp, Gs^Fp, Gs^Fp, Hh
Gs^Fp, Gs^Fp, Gs^Fp, Gs^Fp, Gs^Fp, Gs^Fp, Gs^Fp, Gs^Fp, Gs^Fp, Gs^Fp, Gs^Fp, Gs^Fp, Gs^Fp, Gs^Fp, Gg^Ve, Gs^Fp, Gs^Fp, Gs^Fp, Gs^Fp, Gs^Fp, Gs^Fp, Gs^Fp, Gs^Fp, Gg^Ve, Gs^Fp, Gs^Fp, Hhd
Gs^Fp, Gs^Fp, Gs^Fp, Gs^Fp, Gg, Gs^Fp, Gg, Gs^Fp, Gs^Fp, Gs^Fp, Gs^Fp, Gs^Fp, Gs^Fp, Gs^Fp, Gs^Fp, Gs^Fp, Gs^Fp, Gs^Fp, Gs^Fp, Gs^Fp, Gs^Fp, Gs^Fp, Gs^Fp, Gs^Fp, Gs^Fp, Gs^Fp, Hh
