Md, Md, Md, Md, Md, Gg, Md, Md, Xu, Xu, Rd, Uu, Re, Uu, Rd, Xu, Xu, Uu, Uu, Uu, Re, Uu, Uu, Uu, Rd, Rd, Xu
Md, Md, Md, Md, Md, Md, Md, Md, Xu, Xu, Rd, Re, Re, Uu, Uu, Xu, Xu, Uu^Tf, Uu^Vud, Uh, Re, Uu^Vud, Rd, Rd, Xu, Xu, Xu
Md, Md, Md, Md, Md, Md, Md, Md, Xu, Xu, Rd, Uh, Re, Cud, Uu, Xu, Uu^Vud, Cud, Cud, Cud, Uu^Vud, Uu, Xu, Xu, Xu, Xu, Uu
Md, Md, Md, Md, Md, Md, Md, Md, Xu, Xu, Uh, Rd, Uu^Vud, Re, Re, Uu, Uu^Ii, Cud, 2 Kud, Cud, Uu^Ii, Xu, Xu, Xu, Uu^Tf, Uu, Re
Md, Md, Md, Md, Md^Xm, Md, Md, Md, Xu, Xu, Xu, Uu^Tf, Uu, Cud, Uu, Re, Uu^Vud, Cud, Cud, Cud, Uu^Vud, Xu, Uu, Uu, Uu^Tf, Re, Uh
Md, Md, Md^Xm, Md^Xm, Md, Md^Xm, Md^Xm, Md^Xm, Md^Xm, Xu, Xu, Xu, Xu, Uu^Ii, Uu^Ii, Uu, Rd, Uu^Ii, Uu^Vud, Uu^Ii, Uu, Uu, Cud, Re, Uh, Uh, Rd
Md^Xm, Md^Xm, Md, Md, Md, Md, Md, Md, Md, Md^Xm, Md, Xu, Uu, Cud, Uu^Ii, Uu^Tfi, Re, Re, Uu, Uu, Cud, Uu^Tf, Uu^Tf, Uu^Vud, Rd, Rd, Uh
Md, Md, Re, Re, Rd, Md, Md, Md, Hhd^Dr, Md, Hhd^Vhh, Hhd, Hhd, Hhd^Dr, Hhd^Dr, Re, Uu^Ii, Uu^Ii, Uh^Ii, Uh, Uu^Vud, Uu, Rd, Uh, Uh, Rd, Xu
Rd, Rd, Re, Rd, Hhd^Dr, Hhd, Hhd, Hhd^Dr, Hhd, Hhd^Dr, Hhd^Dr, Hhd, Hhd, Hhd^Dr, Rd, Hhd, Hhd^Dr, Cud, Xu, Xu, Xu, Rd, Rd, Rd, Xu, Xu, Xu
Re, Rd, Rd, Re, Hhd^Dr, Hhd, Hhd, Hhd, Hhd^Dr, Hhd^Dr, Hhd, Hhd, Re, Re, Rd, Re, Re, Rd, Hhd^Dr, Xu, Xu, Xu, Xu, Xu, Xu, Xu, Md
Re, Re, Hhd^Dr, Hhd, Hhd^Dr, Hhd^Dr, Hhd, Hhd, Hhd^Dr, Hhd^Dr, Re, Re, Hhd^Dr, Hhd^Dr, Rd, Hhd, Hhd^Dr, Rd, Hhd^Dr, Hhd, Md, Xu, Xu, Xu, Md, Md, Md
Hhd^Dr, Hhd^Dr, Hhd^Dr, Hhd, Hhd, Hhd^Dr, Hhd, Hhd, Hhd, Hhd, Hhd, Hhd, Rd, Rd, Re, Hhd^Dr, Re, Rd, Rd, Hhd^Vhh, Hhd, Md, Md^Xm, Md, Md, Md, Md
Hhd, Hhd, Hhd^Dr, Hhd, Hhd^Dr, Hhd, Hhd, Hhd, Hhd, Hhd, Re, Re, Rd, Re, Hhd^Dr, Re, Hhd, Re^Vht, Rd, Rd, Hhd, Md, Md^Xm, Md, Md, Md, Md
Hhd, Hhd, Hhd^Vhh, Hhd^Dr, Hhd^Dr, Hhd, Hhd, Hhd^Dr, Hhd^Dr, Hhd^Dr, Re, Re, Rd, Hhd, Hhd, Hhd^Dr, Hhd^Dr, Hhd, Re, Hhd^Dr, Hhd^Dr, Md, Md, Md^Xm, Md^Xm, Md, Md^Xm
Hhd, Hhd, Hhd, Hhd, Hhd^Dr, Hhd^Dr, Hhd, Re^Vht, Hhd, Hhd^Dr, Hhd^Dr, Hhd, Re, Re, Re, Hhd^Dr, Hhd^Dr, Hhd, Hhd, Re, Hhd^Dr, Md, Md, Md, Md, Md^Xm, Md
Hhd, Hhd^Dr, Hhd^Dr, Hhd, Rd, Rd, Rd, Re, Hhd^Dr, Hhd^Dr, Re, Re, Rd, Hhd^Dr, Hhd^Dr, Hhd, Hhd, Hhd, Hhd^Dr, Re, Re, Hhd, Hhd, Md, Hhd^Dr, Md, Hhd
Hhd^Dr, Hhd^Dr, Hhd, Re, Hhd, Hhd, Hhd, Re, Re, Hhd^Dr, Re, Rd, Hhd, Hhd^Dr, Hhd, Hhd, Hhd, Hhd, Hhd^Dr, Hhd^Dr, Re, Re, Re^Vht, Hhd, Hhd^Dr, Hhd^Dr, Hhd
Hhd^Dr, Hhd^Dr, Re, Re, Hhd^Dr, Re, Re, Hhd, Hhd, Re, Rd, Rd, Hhd^Dr, Hhd^Dr, Re, Hhd, Hhd, Hhd^Dr, Hhd, Hhd^Dr, Hhd, Hhd, Hhd, Hhd^Dr, Hhd, Hhd, Hhd
Hhd^Dr, Rd, Hhd, Hhd, Hhd^Dr, Hhd^Dr, Hhd^Dr, Rd, Rd, Hhd, Rd, Hhd, Hhd, Re, Hhd, Hhd, Hhd^Dr, Hhd^Dr, Re^Vht, Hhd, Cte, Hhd, Hhd, Hhd, Hhd^Dr, Hhd^Vhh, Hhd
Rd, Rd, Hhd, Hhd^Dr, Hhd^Dr, Hhd, Hhd, Rd, Hhd^Dr, Hhd^Dr, Re, Hhd, Hhd^Dr, Hhd, Hhd, Hhd, Hhd^Dr, Hhd^Dr, Hhd, Re, Cte, Kte, Hhd, Hhd^Dr, Hhd^Dr, Hhd, Hhd
Re, Rd, Re, Re, Re, Hhd, Hhd, Re, Re, Re, Re, Rd, Hhd^Dr, Hhd^Dr, Hhd, Hhd, Hhd, Hhd, Hhd, Hhd, Hhd^Dr, Hhd^Dr, Re, Hhd^Dr, Hhd^Vhh, Hhd, Hhd^Dr
Hhd, Re, Hhd^Dr, Re, Hhd, Hhd, Hhd, Hhd, Hhd^Dr, Rd, Re, Rd, Re, Hhd^Dr, Hhd^Dr, Hhd, Hhd, Hhd, Hhd^Dr, Hhd, Hhd, Hhd^Dr, Re, Re, Hhd, Hhd^Dr, Hhd^Dr
Hhd, Rd, Hhd^Dr, Hhd^Dr, Hhd, Hhd^Vhh, Hhd^Dr, Hhd^Dr, Hhd, Rd, Hhd, Re, Rd, Hhd^Dr, Hhd^Dr, Hhd, Hhd, Hhd, Hhd^Dr, Hhd^Dr, Re, Hhd, Re^Vht, Re, Re, Hhd^Dr, Hhd
Md, Rd, Rd, Hhd^Dr, Hhd, Hhd, Hhd^Dr, Hhd^Dr, Hhd, Rd, Hhd, Hhd, Rd, Rd, Hhd, Hhd, Hhd, Hhd, Hhd, Hhd^Dr, Re, Re, Hhd^Dr, Hhd, Re, Hhd^Dr, Hhd
Md^Xm, Md, Md, Rd, Re, Hhd^Dr, Hhd^Dr, Hhd, Re, Rd, Re, Hhd^Dr, Re, Hhd, Hhd^Dr, Hhd, Hhd, Hhd, Hhd^Dr, Re, Re, Hhd^Dr, Hhd^Dr, Re, Hhd^Dr, Hhd^Dr, Md
Md^Xm, Md^Xm, Md, Hhd, Hhd, Re, Hhd, Re, Rd, Re, Hhd^Dr, Hhd^Dr, Re, Hhd^Dr, Hhd, Hhd, Hhd, Hhd^Dr, Re, Hhd^Dr, Re, Hhd, Hhd, Re, Hhd, Md, Md
Md^Xm, Md^Xm, Md, Hhd^Dr, Hhd^Dr, Hhd, Sm, Hhd, Rd, Hhd^Dr, Rd, Re, Hhd, Hhd, Hhd, Hhd^Dr, Hhd^Dr, Hhd, Re, Hhd^Dr, Hhd^Dr, Hhd, Hhd, Re, Md, Md^Xm, Md^Xm
Md^Xm, Md, Md, Hhd^Dr, Hhd^Dr, Sm, Sm, Sm, Hhd, Rd, Hhd^Dr, Hhd, Hhd^Dr, Hhd, Hhd, Hhd^Dr, Hhd^Dr, Re, Re^Vht, Re, Hhd^Dr, Hhd^Dr, Re, Hhd, Md, Md^Xm, Md^Xm
Md, Md, Chr, Chs, Chs, Ss, Ss, Ss, Re, Rd, Rd, Hhd^Dr, Sm, Hhd, Hhd, Hhd, Hhd^Dr, Hhd^Dr, Hhd, Hhd, Rd, Rd, Rd, Re, Md, Md^Xm, Md^Xm
Md, Md, Chr, Khs, Chs, Ss, Sm, Hhd, Re, Hhd, Hhd, Hhd^Dr, Hhd^Dr, Sm, Hhd, Hhd, Sm, Hhd^Dr, Re, Rd, Hhd^Dr, Re, Hhd^Dr, Hhd^Dr, Md, Md^Xm, Md^Xm
Hhd, Hhd^Dr, Hhd^Dr, Chs, Re, Sm, Sm, Sm, Hhd^Dr, Hhd^Vhh, Hhd, Hhd^Dr, Rd, Re, Hhd, Sm, Sm, Re, Hhd, Hhd, Hhd^Dr, Re^Vht, Hhd, Hhd^Dr, Hhd^Dr, Md, Hhd
Hhd, Hhd^Dr, Hhd^Dr, Sm, Re, Re, Hhd, Hhd, Sm, Hhd^Dr, Hhd, Sm, Sm, Rd, Rd, Sm, Hhd, Hhd, Hhd^Dr, Hhd, Hhd, Re, Re, Hhd^Dr, Rb, Hhd, Rb
Rd, Hhd, Hhd^Dr, Hhd^Dr, Sm, Re, Sm, Sm, Hhd^Dr, Sm, Sm, Sm, Hhd, Hhd, Re, Rd, Rd, Hhd^Dr, Hhd^Dr, Hhd, Re, Hhd, Ss, Re, Re, Re, Wo
Rd, Rd, Re, Hhd^Dr, Sm, Re, Sm, Sm, Sm, Sm, Re, Hhd, Hhd, Rd, Rd, Hhd, Hhd, Rd, Hhd^Dr, Hhd^Dr, Ww, Ss, Wo, Ww, Wo, Wo, Ss
Re, Re, Sm, Re, Sm, Sm, Hhd, Re, Ss, Re, Ww, Hhd^Vhh, Ww, Re, Re, Re, Hhd, Hhd, Wwf, Chw, Ww, Wo, Wo, Wo, Ss, Ss, Ss
Hhd, Ss, Ss, Ss, Hhd, Ss, Ww, Ss, Wo, Ww, Wo, Wo, Wo, Wo, Wo, Ww, Chw, Wwf, Rd, Hhd, Re, Ww, Re, Ss, Hhd, Ss^Vhs, Hhd
Hhd, Re, Ww, Ww, Ww, Ww, Wo, Wo, Wo, Ww, Ss, Ss^Vm, Ss, Ww, Ww, Ww, Hhd, Hhd^Dr, Rd, Hhd, Hhd^Dr, Re, Rd, Hhd, Hhd, Hhd, Hhd
Ww, Ww, Wo, Wo, Ww, Ww, Ww, Ww, Hhd^Dr, Hhd^Dr, Hhd^Dr, Ss, Hhd, Re, Re, Re, Rd, Hhd^Dr, Re, Hhd, Hhd^Dr, Hhd^Dr, Hhd, Rd, Rd, Hhd^Dr, Hhd^Dr
Ww, Wo, Ww, Ww, Ss, Ss, Re, Re, Gs, Gs, Gs, Hhd^Dr, Hhd, Hhd, Hhd^Dr, Hhd^Dr, Hhd, Rd, Re, Hhd, Hhd^Dr, Hhd, Hhd, Hhd, Re, Hhd^Dr, Hhd^Dr
Ww, Ww, Re, Re, Gs, Gs, Hhd, Gd, Hhd, Hhd, Hhd^Dr, Gs, Gs, Hhd, Gd, Hhd^Dr, Rd, Re, Hhd, Hhd^Dr, Hhd^Dr, Hhd, Re, Hhd, Hhd, Re, Hhd
Hhd, Hhd^Dr, Hhd^Dr, Hhd, Gd, Gs, Gs, Gs, Gd, Hhd^Dr, Gs, Hhd, Gs, Gs, Gd, Gd, Rd, Hhd, Hhd, Hhd^Dr, Re, Re, Hhd^Dr, Rd, Hhd, Re, Hhd
Hhd^Dr, Hhd^Dr, Hhd, Hhd, Gd, Gd, Gd, Hhd^Dr, Hhd^Dr, Gs, Gs, Gd, Gs, Hhd, Gs, Gs^Vht, Rd, Hhd, Hhd, Rd, Hhd^Dr, Hhd^Dr, Rd, Rd, Hhd, Re, Hhd
Hhd^Dr, Hhd^Dr, Hhd, Gs, Hhd, Hhd, Hhd^Dr, Gd, Gd, Gs, Hhd^Dr, Hhd^Dr, Gd, Re, Re, Rd, Re, Hhd, Hhd, Rd, Hhd^Dr, Hhd^Dr, Re, Hhd, Rd, Rd, Hhd^Dr
Hhd, Hhd, Hhd, Gs, Hhd, Hhd, Hhd^Dr, Hhd^Dr, Hhd, Gs, Gs, Hhd, Hhd^Dr, Re, Re, Re, Rd, Hhd, Hhd, Hhd^Dr, Gs, Re, Re, Hhd, Rd, Hhd^Dr, Hhd^Dr
Hhd, Hhd, Hhd, Hhd^Dr, Hhd^Dr, Hhd^Dr, Hhd, Hhd, Gs, Gs, Gd, Gs, Re, Hhd^Dr, Hhd^Dr, Rd, Hhd, Hhd, Hhd^Dr, Hhd, Gs, Hhd, Re, Re, Hhd^Dr, Hhd^Dr, Hhd
Hhd^Dr, Hhd^Dr, Hhd, Gs, Gs, Gd, Gs, Hhd, Gs, Gs, Hhd, Hhd, Hhd, Re, Gs, Rd, Hhd, Hhd^Dr, Gs, Hhd, Gs, Gs, Hhd^Dr, Hhd, Hhd^Dr, Hhd^Dr, Hhd
Hhd, Hhd^Dr, Gs^Fms, Gs^Fms, Gs^Fms, Gd, Gd, Gs, Gs, Hhd, Gs^Fms, Hhd^Dr, Hhd^Dr, Hhd, Hhd, Rd, Hhd, Gs, Gd, Hhd, Gs, Hhd^Dr, Gd, Gs, Gd, Hhd, Hhd^Dr
Hhd^Dr, Gs^Fms, Hhd, Gs^Fms, Gs^Fms, Gs^Fms, Gs^Fms, Gs^Fms, Gs^Fms, Gs^Fms, Gs^Fp, Gs^Fp, Cv, Cv, Cv, Gs^Fms, Gs^Fp, Hhd, Hhd, Gd, Hhd, Gs, Gs, Gs, Gs, Hhd, Hhd^Dr
Hhd^Dr, Hhd^Dr, Gs^Fp, Gs^Fp, Gs^Fp, Gs^Fp, Gs^Fp, Gs^Fp, Gg^Ve, Gs^Fp, Gs^Fms, Gs^Fp, Cv, 1 Kv, Cv, Gs^Fms, Gs^Fms, Gs^Fms, Gs^Fms, Gs^Fms, Gs, Gs^Fms, Hhd, Gs, Hhd^Dr, Hhd^Dr, Hhd
Gs^Fp, Gs^Fp, Gs^Fp, Gs^Fms, Gs^Fp, Gs^Fp, Gs^Fp, Gs^Fp, Gs^Fp, Gs^Fp, Gs^Fp, Gs^Fp, Gs^Fp, Cv, Gs^Fp, Gs^Fms, Gs^Fp, Gs^Fp, Gs^Fp, Gs^Fp, Gs^Fms, Gd, Gd, Gd, Gs^Fp, Hhd^Dr, Hhd
Gs^Fp, Gs^Fp, Gg^Ve, Gs^Fp, Gs^Fp, Gs^Fp, Gs^Fp, Gs^Fp, Gs^Fp, Gs^Fp, Gs^Fp, Gs^Fms, Gs^Fp, Gs^Fp, Gs^Fp, Gs^Fp, Gs^Fp, Gs^Fp, Gg^Ve, Gs^Fp, Gs^Fp, Gs^Fms, Gs^Fp, Gs^Fp, Gs^Fp, Gs^Fp, Hhd
Gs^Fp, Gs^Fp, Gs^Fp, Gs^Fp, Gs^Fp, Gs^Fp, Gs^Fp, Gs^Fp, Gs^Fp, Gs^Fp, Gs^Fp, Gs^Fp, Gs^Fp, Gs^Fp, Gg^Ve, Gs^Fp, Gs^Fp, Gs^Fp, Gs^Fp, Gs^Fp, Gs^Fp, Gs^Fp, Gs^Fp, Gg^Ve, Gs^Fp, Gs^Fp, Hhd
Gs^Fp, Gs^Fp, Gs^Fp, Gs^Fp, Gg, Gs^Fp, Gg, Gs^Fp, Gs^Fp, Gs^Fp, Gs^Fp, Gs^Fp, Gs^Fp, Gs^Fp, Gs^Fp, Gs^Fp, Gs^Fp, Gs^Fp, Gs^Fp, Gs^Fp, Gs^Fp, Gs^Fp, Gs^Fp, Gs^Fp, Gs^Fp, Gs^Fp, Hh
