Hhd^Dr, Hhd^Dr, Hhd, Hhd^Dr, Gd, Rd, Gd, Hhd^Dr, Hhd^Dr, Hhd^Dr, Hhd, Hhd, Hhd^Dr, Hhd^Dr, Hhd^Dr, Hhd, Hhd^Dr, Gd, Rd, Rd, Gd, Rd, Gd, Gd, Gd, Rd, Rd, Gd, Hhd, Hhd^Dr, Hhd^Dr, Hhd, Hhd^Dr, Hhd^Dr, Hhd, Hhd, Hhd, Hhd, Hhd^Dr, Hhd^Dr, Hhd, Hhd
Hhd, Hhd^Dr, Hhd, Hhd^Dr, Gd, Gd, Rd, Gd, Hhd, Hhd, Gd, Hhd, Hhd, Hhd^Dr, Hhd^Dr, Hhd, Hhd, Gd, Gd, Gd, Gd^Vh, Gd, Gd, Gd, Gd, Rd, Rd, Gd, Hhd, Hhd^Dr, Hhd^Dr, Rd, Rd, Hhd^Dr, Gd, Hhd^Dr, Hhd^Dr, Hhd, Hhd^Dr, Hhd^Dr, Hhd, Hhd^Dr
Hhd, Hhd^Dr, Hhd^Dr, Hhd, Gd, Rd, Rd, Rd, Rd, Gd, Hhd^Dr, Hhd^Dr, Rd, Hhd, Hhd^Dr, Hhd^Dr, Hhd, Hhd, Hhd^Dr, Gd, Gd, Gd, Hhd, Gd, Gd, Gd, Rd, Gd, Hhd^Dr, Gd, Gd, Hhd^Dr, Hhd, Hhd, Gd, Hhd^Dr, Cer, Cer, Cer, Hhd, Hhd, Hhd^Dr
Hhd^Dr, Hhd^Dr, Gd, Gd, Hhd, Gd, Rd, Rd^Vh, Rd, Hhd, Hhd^Dr, Hhd^Dr, Hhd, Hhd, Rd, Hhd^Dr, Rd, Hhd, Hhd^Dr, Hhd^Dr, Hhd, Hhd, Rd, Hhd^Dr, Gd, Gd, Rd, Gd, Gd, Hhd^Dr, Gd, Gd, Gd, Hhd, Gd, Hhd^Dr, Cer, 7 Ker, Cer, Rd, Hhd^Dr, Rd
Hhd, Hhd^Dr, Gd, Hhd, Rd, Hhd, Md, Md, Md, Md, Md, Hhd, Hhd^Dr, Hhd^Dr, Rd, Hhd, Rd^Vht, Hhd^Dr, Gd, Hhd^Dr, Hhd^Dr, Rd, Hhd^Dr, Hhd^Dr, Hhd^Dr, Gd, Gd, Gd, Hhd, Hhd^Dr, Hhd^Dr, Hhd^Dr, Hhd, Hhd, Hhd^Dr, Hhd^Dr, Gd, Cer, Rd, Hhd, Hhd^Dr, Hhd^Dr
Hhd, Hhd, Hhd^Dr, Hhd^Dr, Rd, Rd, Rd, Md, Md, Md, Md, Hhd, Hhd^Dr, Rd, Hhd, Rd, Hhd^Dr, Gd, Hhd, Hhd^Dr, Hhd^Dr, Hhd, Hhd, Hhd^Dr, Gd, Gd, Md, Gd, Gd, Gd, Gd, Hhd^Dr, Gd, Rd^Vh, Rd, Gd, Re, Rd, Hhd, Rd, Hhd^Dr, Rd
Hhd^Dr, Hhd, Hhd, Hhd^Dr, Hhd^Dr, Hhd, Hhd, Hhd, Md, Md, Rd, Hhd^Dr, Gd, Hhd, Gd, Hhd, Hhd^Dr, Hhd^Dr, Hhd, Hhd, Hhd^Vhh, Hhd, Hhd, Gd, Md, Md, Md, Md, Gd, Gd, Gd, Hhd, Gd, Rd, Re, Re, Gd, Hhd, Gd, Hhd^Dr, Md, Md
Hhd^Dr, Hhd^Dr, Hhd, Hhd^Dr, Gd, Gd, Gd, Gd^Vht, Hhd^Dr, Rd, Hhd, Hhd^Dr, Hhd^Dr, Hhd, Hhd, Gd, Cte, Cte, Cte, Hhd^Dr, Hhd^Dr, Gd, Rd, Rd, Md, Md, Md, Md, Hhd^Dr, Gd, Gd, Gd, Re, Re, Rd, Rd, Gd, Hhd^Dr, Hhd^Dr, Md, Md, Md
Hhd^Dr, Hhd, Hhd, Gd, Gd, Gd, Hhd, Hhd, Hhd^Dr, Rd, Hhd, Hhd^Dr, Gd, Hhd, Hhd^Dr, Hhd^Dr, Cte, 6 Kte, Cte, Hhd^Dr, Gd, Gd, Rd, Rd, Hhd, Md, Hhd^Dr, Hhd^Dr, Hhd, Hhd, Hhd, Re, Gd, Gd, Rd, Gd, Hhd^Dr, Hhd^Dr, Hhd, Md, Md, Md
Hhd^Dr, Hhd^Dr, Hhd^Dr, Gd, Cer, Hhd, Hhd, Gd, Hhd^Dr, Hhd^Dr, Hhd, Gd, Gd, Hhd, Hhd^Dr, Hhd^Dr, Hhd, Cte, Hhd^Dr, Gd, Rd, Rd, Gd, Gd, Gd, Hhd, Hhd^Dr, Hhd^Dr, Hhd^Vhh, Hhd, Gd, Re, Hhd, Hhd, Gd, Gd, Hhd^Dr, Gd, Rd, Hhd, Gd, Md
Hhd, Hhd, Gd, Cer, 8 Ker, Cer, Gd, Re, Re, Hhd^Dr, Gd, Gd, Gd, Hhd^Dr, Hhd^Dr, Gd, Re, Hhd^Dr, Hhd^Dr, Gd, Hhd^Dr, Gd, Gd, Hhd^Dr, Hhd^Dr, Gd, Hhd, Hhd, Hhd^Dr, Hhd^Dr, Gd, Re, Gd, Hhd, Hhd, Hhd^Dr, Hhd^Dr, Rd, Rd, Rd, Gd, Hhd
Hhd, Gd, Hhd^Dr, Cer, Cer, Cer, Hhd, Re, Re, Gd, Hhd^Dr, Hhd^Dr, Gd, Hhd^Dr, Re, Re, Re, Hhd^Dr, Hhd, Hhd, Hhd^Dr, Hhd^Dr, Gd, Hhd^Dr, Gd, Hhd^Dr, Hhd, Hhd, Hhd, Hhd^Dr, Hhd^Dr, Re, Gd, Gd, Gd, Gd, Gd, Gd, Hhd, Gd, Md, Md
Hhd, Gd, Hhd, Hhd^Dr, Hhd^Dr, Hhd^Dr, Rd, Hhd, Re, Hhd, Rd, Hhd^Dr, Gd, Hhd, Re, Re, Gd, Hhd, Gd, Hhd^Dr, Gd, Hhd, Gd, Hhd, Gd, Hhd, Hhd, Hhd, Hhd, Hhd^Dr, Hhd^Dr, Re, Hhd^Dr, Hhd^Dr, Hhd^Dr, Gd, Hhd^Dr, Hhd, Hhd^Dr, Md, Md, Md
Hhd^Dr, Gd, Gd, Hhd, Gd, Rd, Hhd^Dr, Md, Hhd^Dr, Hhd, Rd, Hhd^Dr, Hhd^Dr, Re, Gd, Gd, Rd, Gd, Gd, Hhd^Dr, Gd, Gd, Gd, Hhd, Gd, Hhd, Cer, Cer, Cer, Rd, Rd, Rd, Re, Hhd, Rd, Hhd^Dr, Rd, Hhd, Md, Md, Md, Md
Hhd^Dr, Hhd^Dr, Hhd^Dr, Gd, Rd, Rd, Md, Md, Gd, Re, Re, Rd, Hhd^Dr, Gd, Rd, Rd, Rd, Gd, Gd, Gd, Gd^Vht, Gd, Gd, Gd, Re, Hhd, Cer, 5 Ker, Cer, Hhd^Dr, Re, Rd, Rd, Hhd, Hhd, Hhd^Dr, Rd, Hhd, Md, Md, Md, Md
Hhd, Gd, Hhd^Dr, Hhd^Dr, Md, Md, Md, Md, Hhd, Rd^Vh, Rd, Re, Re, Gd, Gd, Rd, Gd, Gd^Vh, Gd, Gd, Gd, Gd, Re, Re, Hhd, Hhd, Hhd^Dr, Cer, Hhd, Hhd^Dr, Hhd^Dr, Rd, Rd, Rd^Vh, Rd, Re, Re, Hhd, Md, Md, Md, Md
Hhd, Gd, Hhd, Md, Md, Md, Md, Hhd, Rd, Rd, Hhd^Dr, Hhd, Re, Gd, Hhd, Gd, Hhd^Dr, Gd, Gd, Gd, Hhd, Hhd, Re, Hhd^Dr, Hhd^Dr, Hhd, Gd, Hhd^Dr, Rd, Hhd, Hhd, Re, Hhd, Re, Hhd, Re, Hhd^Dr, Rd, Hhd^Dr, Md, Md, Md
Hhd, Gd, Hhd, Gd, Gd, Hhd^Dr, Gd, Gd, Rd, Rd, Hhd^Dr, Hhd^Dr, Re, Hhd, Re, Hhd, Re, Hhd^Dr, Gd, Gd, Gd, Gd, Hhd^Dr, Hhd^Dr, Hhd, Gd, Gd, Hhd^Dr, Hhd^Dr, Hhd, Md, Hhd, Hhd^Dr, Re, Hhd, Hhd, Hhd^Dr, Hhd^Dr, Rd, Hhd^Dr, Md, Md
Hhd, Hhd, Rd, Rd, Hhd^Dr, Hhd, Hhd^Vhh, Hhd^Dr, Gd, Hhd, Hhd, Hhd^Dr, Re, Hhd^Dr, Hhd^Dr, Re, Re, Hhd^Dr, Gd, Hhd, Hhd, Hhd, Hhd^Dr, Hhd^Dr, Hhd, Gd, Gd, Hhd^Dr, Hhd^Dr, Md, Md, Md, Hhd^Dr, Hhd^Dr, Gd, Gd, Hhd, Hhd, Rd, Hhd^Dr, Hhd^Vhh, Md
Hhd, Hhd^Dr, Hhd^Dr, Rd, Gd, Gd, Hhd, Hhd^Dr, Gd, Hhd, Hhd, Hhd^Dr, Hhd^Dr, Hhd, Hhd, Hhd, Hhd, Hhd^Dr, Hhd^Dr, Hhd, Re, Re, Gd, Gd, Rd, Rd, Rd, Gd, Rd, Hhd, Hhd, Hhd, Gd, Hhd^Dr, Gd, Hhd, Rd, Rd, Gd, Hhd, Md, Md
Rd, Hhd^Dr, Hhd^Dr, Gd, Hhd, Rd, Rd, Gd, Hhd, Rd, Hhd, Hhd^Dr, Hhd^Dr, Hhd, Hhd^Dr, Hhd, Hhd^Vhh, Hhd^Dr, Re, Re, Gd, Hhd, Rd, Rd, Rd, Rd, Rd, Rd, Rd, Rd, Gd, Gd, Gd, Hhd^Dr, Hhd^Dr, Gd, Rd, Rd, Gd, Hhd^Dr, Hhd^Dr, Hhd
Rd, Rd, Gd, Hhd^Dr, Hhd, Rd, Hhd, Gd, Hhd^Dr, Rd, Cer, Cer, Cer, Hhd, Hhd, Hhd^Dr, Hhd, Hhd, Rd, Rd, Rd, Gd, Rd, Rd, Hhd^Dr, Rd, Gd, Gd, Rd, Gd, Md, Gd^Vht, Hhd, Hhd^Dr, Rd, Rd, Gd, Rd, Md^Vhh, Hhd^Dr, Md, Hhd
Rd, Gd, Hhd^Dr, Hhd^Dr, Hhd, Hhd, Md, Hhd, Hhd^Dr, Hhd^Dr, Cer, 4 Ker, Cer, Hhd, Gd, Hhd^Dr, Hhd^Dr, Hhd, Hhd, Rd, Gd, Gd, Gd, Gd, Hhd, Hhd^Dr, Hhd^Dr, Md^Vhh, Md, Md, Md, Md, Md, Md, Md, Md, Md, Md, Md, Md, Md^Xm, Md^Xm
Rd, Rd, Hhd, Hhd, Hhd^Dr, Md, Md, Hhd, Rd, Rd, Hhd, Cer, Hhd, Gd, Hhd^Dr, Re, Re, Hhd, Hhd, Gd, Gd, Gd, Hhd, Hhd, Hhd, Hhd^Dr, Md, Md, Md, Md, Md, Md, Md, Md, Md, Md^Xm, Md^Xm, Md, Md, Md, Md^Xm, Md^Xm
Rd, Gd, Hhd, Hhd^Dr, Hhd^Dr, Md, Md, Rd, Hhd, Rd, Gd, Gd, Hhd, Gd, Hhd, Hhd^Dr, Hhd^Dr, Re, Hhd, Hhd, Hhd^Dr, Hhd, Hhd, Hhd^Dr, Hhd^Dr, Hhd^Dr, Hhd^Dr, Md, Md, Md, Md, Md, Md, Md^Xm, Md^Xm, Md, Md, Md^Xm, Md^Xm, Md^Xm, Md^Xm, Md^Xm
Rd^Dr, Hhd^Dr, Hhd, Hhd^Dr, Md, Md, Md, Md, Gd, Gd, Gd, Rd, Rd^Vht, Rd, Hhd, Hhd^Dr, Hhd^Dr, Re, Hhd, Hhd^Dr, Hhd^Dr, Hhd, Hhd, Hhd^Dr, Hhd, Hhd, Md, Md, Md, Md, Md, Md, Md^Vhh, Md, Md, Md^Xm, Md^Xm, Md^Xm, Xu, Xu, Xu, Xu
Hhd, Hhd^Dr, Hhd, Hhd^Dr, Hhd^Dr, Md, Hhd, Md, Gd, Gd, Rd, Rd, Hhd, Hhd, Hhd^Dr, Hhd, Hhd, Re, Gd, Hhd^Dr, Gd^Vht, Hhd, Gd, Gd, Cf, Gd, Md, Md^Vhh, Md^Xm, Md, Md, Md, Md^Xm, Md^Xm, Md^Xm, Md^Xm, Xu, Xu, Xu, Xu, Xu, Xu
Hhd^Dr, Hhd, Hhd, Hhd^Dr, Hhd^Dr, Hhd, Md, Hhd, Md, Md^Vhh, Md, Hhd, Hhd, Hhd, Gd, Hhd^Dr, Gd, Gd, Gd, Gd^Vht, Gd, Gd^Vht, Gd, Cf, 2 Kf, Cf, Md, Md, Md^Xm, Md^Xm, Md^Xm, Md^Xm, Xu, Xu, Xu, Xu, Xu, Xu, Xu, Xu, Xu, Xu
Hhd^Dr, Hhd^Dr, Hhd, Hhd, Hhd^Dr, Hhd^Dr, Md, Md, Md, Md, Md, Md, Cf, Cf, Cf, Gd, Gd, Gd, Uu^Vu, Gd, Uu^Ii, Gd, Uu^Vu, Cf, Cf, Cf, Xu, Md^Xm, Xu, Xu, Xu, Xu, Xu, Xu, Xu, Xu, Xu, Xu, Xu, Xu, Xu, Xu
Hhd^Dr, Hhd^Dr, Md, Hhd, Md, Hhd^Dr, Md^Xm, Md, Md, Md, Md, Md, Cf, 3 Kf, Cf, Gd, Re, Uu^Ii, Cf, Cf, Cf, Uu^Ii, Uu^Ii, Uu^Ii, Xu, Xu, Xu, Xu, Xu, Xu, Xu, Xu, Xu, Xu, Xu, Xu, Xu, Xu, Xu, Xu, Xu, Xu
Md, Md, Md, Md, Md, Md, Md, Md^Xm, Md^Xm, Md, Md^Xm, Md^Xm, Xu, Cf, Uu^Ii, Uu^Ii, Uu^Ii, Re, Cf, 1 Kf, Cf, Uu^Ii, Uu, Uh^Ii, Xu, Xu, Xu, Xu, Xu, Xu, Xu, Xu, Xu, Xu, Xu, Xu, Xu, Xu, Xu, Xu, Xu, Xu
Md, Md, Md, Md, Md, Md^Vhh, Md, Md, Md^Xm, Md^Xm, Xu, Xu, Xu, Xu, Xu, Uu^Ii, Uu, Re, Re, Cf, Uu, Rd, Uu^Vud, Uh, Xu, Xu, Xu, Xu, Xu, Xu, Xu, Xu, Xu, Xu, Xu, Xu, Xu, Xu, Xu, Xu, Xu, Xu
Md, Md^Xm, Md, Md, Md, Md, Md, Md^Xm, Xu, Xu, Xu, Xu, Xu, Xu, Xu, Xu, Xu, Uu^Ebn, Uu, Re, Uu, Rd, Uu, Uh, Xu, Xu, Xu, Xu, Xu, Xu, Xu, Xu, Xu, Xu, Xu, Xu, Xu, Xu, Xu, Xu, Xu, Xu
Md, Md, Md^Vhh, Md, Md, Md, Md^Xm, Md^Xm, Xu, Xu, Xu, Xu, Xu, Xu, Xu, Xu, Xu, Uu^Vud, Rd, Rd, Uu, Rd, Rd, Uh, Uh, Xu, Xu, Xu, Xu, Xu, Xu, Xu, Xu, Xu, Xu, Xu, Xu, Xu, Xu, Xu, Xu, Xu
Md^Xm, Md^Xm, Md^Xm, Md^Xm, Md^Xm, Md^Xm, Xu, Xu, Xu, Xu, Xu, Xu, Xu, Xu, Xu, Xu, Xu, Xu, Uu, Rd, Uu, Uu, Uu, Uu^Ebn, Uu, Xu, Xu, Xu, Xu, Xu, Xu, Xu, Xu, Xu, Xu, Xu, Xu, Xu, Xu, Xu, Xu, Xu
Xu, Xu, Xu, Xu, Xu, Xu, Xu, Xu, Xu, Xu, Xu, Xu, Xu, Xu, Xu, Xu, Xu, Xu, Uu, Rd, Rd, Re, Re, Uu, Uu, Re, Re, Xu, Xu, Xu, Xu, Xu, Xu, Xu, Xu, Xu, Xu, Xu, Xu, Xu, Xu, Xu
Xu, Xu, Xu, Xu, Xu, Xu, Xu, Xu, Xu, Xu, Xu, Xu, Xu, Xu, Xu, Xu, Xu, Xu, Xu, Uu^Vu, Uh, Uu, Re, Uu, Uu, Uu, Uu, Uu^Vu, Uu, Uu, Uu^Ebn, Uu, Uu^Vu, Xu, Xu, Xu, Xu, Xu, Xu, Xu, Xu, Xu
Xu, Xu, Xu, Xu, Xu, Xu, Xu, Xu, Xu, Xu, Xu, Xu, Xu, Xu, Xu, Xu, Xu, Xu, Xu, Uh, Uh, Uh, Uu, Re, Uu, Rd, Uu, Uu, Re, Re, Rd, Uu, Uu, Uh, Xu, Xu, Xu, Xu, Xu, Xu, Xu, Xu
Xu, Xu, Xu, Xu, Xu, Xu, Xu, Xu, Xu, Xu, Xu, Xu, Xu, Xu, Xu, Xu, Xu, Xu, Xu, Xu, Uh, Uh, Uu^Ebn, Re, Rd, Rd, Rd, Rd, Rd, Uu, Uu, Rd, Uh, Uh, Uh, Xu, Xu, Xu, Xu, Xu, Xu, Xu
Xu, Xu, Xu, Xu, Xu, Xu, Xu, Xu, Xu, Xu, Xu, Xu, Xu, Xu, Xu, Xu, Xu, Xu, Xu, Xu, Xu, Uu^Vud, Uu, Uu, Uu, Uu, Uu, Uu, Uu, Rd, Uu, Rd, Rd, Uh, Uu, Xu, Xu, Xu, Xu, Xu, Xu, Xu
Xu, Xu, Xu, Xu, Xu, Xu, Xu, Xu, Xu, Xu, Xu, Xu, Xu, Xu, Xu, Xu, Xu, Xu, Xu, Xu, Xu, Xu, Xu, Xu, Xu, Xu, Xu, Xu, Xu, Uu, Xu, Uu^Ebn, Uu^Vu, Rd, Rd, Uu^Vud, Uu, Xu, Xu, Xu, Xu, Xu
Xu, Xu, Xu, Xu, Xu, Xu, Xu, Xu, Xu, Xu, Xu, Xu, Xu, Xu, Xu, Xu, Xu, Xu, Xu, Xu, Xu, Xu, Xu, Xu, Xu, Xu, Xu, Xu, Xu, Xu, Xu, Xu, Uu, Uu, Uu, Uu, Uu, Uu, Uu, Xu, Xu, Xu
