Hhd, Hhd, Hh, Hh, Gs, Gg, Gs, Hh, Hhd, Hh, Hhd, Hh, Hhd, Hhd, Hh, Hhd, Hhd, Gs, Gg, Gg, Gs, Uu, Gs, Gs, Gs, Gg, Gg, Gs, Hhd, Hhd, Hh, Hh, Hhd, Hh, Hh, Hh, Hh, Hhd, Hhd, Hhd, Hh, Hh
Hh, Hh, Hhd, Hhd, Gs, Gs, Gg, Gs, Hh, Hh, Gs, Hh, Hhd, Hh, Hhd, Hh, Hh, Gs, Gs, Gs, Gg^Vh, Gs, Gs, Gs, Gs, Gg, Gg, Gs, Hhd, Hhd, Hhd, Gs, Gs, Hh, Gs, Hhd, Hhd, Hhd, Hhd, Hh, Hhd, Hh
Hhd, Hhd, Hh, Hhd, Gs, Gg, Gg, Gg, Gg, Gs, Hh, Hh, Gs, Hhd, Hhd, Hhd, Hhd, Hhd, Hhd, Gs, Gs, Gs, Hh, Gs, Gs, Gs, Gg, Gs, Hhd, Gs, Gs, Hhd, Hh, Hh, Gs, Hh, Cer, Cer, Cer, Hhd, Hh, Hhd
Hh, Hh, Gs, Gs, Hhd, Gs, Gg, Gg^Vh, Gs, Hh, Hhd, Hh, Hhd, Hh, Gs, Hhd, Gs, Hh, Hhd, Hhd, Hh, Hh, Gs, Hhd, Gs, Gs, Gg, Gs, Gs, Hhd, Gs, Gs, Gs, Hhd, Gs, Hhd, Cer, 7 Ker, Cer, Gs, Hhd, Gs
Hh, Hh, Gs, Hh, Gs, Hhd, Mm, Mm, Mm, Mm, Mm, Hhd, Hh, Hh, Gs, Hh, Gs^Vht, Hhd, Gs, Hh, Hhd, Gs, Hhd, Hhd, Hh, Gs, Gs, Gs, Hhd, Hhd, Hh, Hhd, Hhd, Hhd, Hh, Hhd, Gs, Cer, Gs, Hhd, Hh, Hhd
Hh, Hh, Hhd, Hhd, Hhd, Hhd, Gs, Mm, Mm, Mm, Mm, Hhd, Hhd, Gs, Hh, Gs, Hh, Gs, Hhd, Hh, Hh, Hh, Hh, Hh, Gs, Gs, Mm, Gs, Gs, Gs, Gs, Hh, Gs, Gg^Vh, Gg, Gs, Rd, Gs, Hh, Gs, Hh, Gs
Hh, Hh, Hhd, Hhd, Hh, Hhd, Hh, Hh, Mm, Mm, Gs, Hhd, Gs, Hh, Gs, Hh, Hh, Hhd, Hhd, Hhd, Hh^Vhh, Hhd, Hh, Gs, Mm, Mm, Mm, Mm, Gs, Gs, Gs, Hh, Gs, Gg, Rd, Rd, Gs, Hhd, Gs, Hhd, Mm, Mm
Hh, Hh, Hhd, Hhd, Gs, Gs, Gs, Gs^Vht, Hhd, Gs, Hhd, Hhd, Hh, Hh, Hh, Gs, Cte, Cte, Cte, Hh, Hhd, Gs, Gg, Gg, Mm, Mm, Mm, Mm, Hhd, Gs, Gs, Gs, Rd, Rd, Gg, Gg, Gs, Hhd, Hh, Mm, Mm, Mm
Hh, Hhd, Hh, Gs, Gs, Gs, Hhd, Hh, Hh, Gs, Hh, Hh, Gs, Hhd, Hhd, Hhd, Cte, 6 Kte, Cte, Hh, Gs, Gs, Gg, Gg, Hh, Mm, Hhd, Hh, Hh, Hhd, Hhd, Rd, Gs, Gs, Gg, Gs, Hhd, Hh, Hh, Mm, Mm, Mm
Hhd, Hh, Hh, Gs, Cer, Hhd, Hh, Gs, Hh, Hhd, Hh, Gs, Gs, Hhd, Hhd, Hhd, Hhd, Cte, Hh, Gs, Gg, Gg, Gs, Gs, Gs, Hhd, Hhd, Hh, Hh^Vhh, Hh, Gs, Rd, Hhd, Hhd, Gs, Gs, Hh, Gs, Gg, Hh, Gs, Mm
Hhd, Hh, Gs, Cer, 8 Ker, Cer, Gs, Rd, Rd, Hhd, Gs, Gs, Gs, Hhd, Hh, Gs, Rd, Hhd, Hh, Gs, Hhd, Gs, Gs, Hh, Hhd, Gs, Hh, Hhd, Hhd, Hh, Gs, Rd, Gs, Hhd, Hhd, Hh, Hhd, Gg, Gg, Gg, Gs, Hh
Hhd, Gs, Hh, Cer, Cer, Cer, Hh, Rd, Rd, Gs, Hhd, Hh, Gs, Hh, Rd, Rd, Rd, Hh, Hhd, Hhd, Hh, Hh, Gs, Hh, Gs, Hhd, Hh, Hhd, Hhd, Hh, Hh, Rd, Gs, Gs, Gs, Gs, Gs, Gs, Hh, Gs, Mm, Mm
Hhd, Gs, Hhd, Hhd, Hhd, Hhd, Gs, Hhd, Rd, Hh, Gs, Hh, Gs, Hh, Rd, Rd, Gs, Hhd, Gs, Hhd, Gs, Hhd, Gs, Hhd, Gs, Hhd, Hh, Hh, Hh, Hhd, Hhd, Rd, Hhd, Hh, Hh, Gs, Hhd, Hh, Hhd, Mm, Mm, Mm
Hhd, Gs, Gs, Hh, Gs, Gs, Hh, Mm, Hhd, Hh, Gg, Hh, Hh, Rd, Gs, Gs, Gg, Gs, Gs, Hh, Gs, Gs, Gs, Hh, Gs, Hhd, Cer, Cer, Cer, Gs, Gs, Gg, Gs, Hhd, Gs, Hh, Gs, Hh, Mm, Mm, Mm, Mm
Hh, Hh, Hhd, Gs, Gs, Gs, Mm, Mm, Gs, Rd, Rd, Gs, Hh, Gs, Gg, Gg, Gg, Gs, Gs, Gs, Gs^Vht, Gs, Gs, Gs, Rd, Hh, Cer, 5 Ker, Cer, Hh, Gs, Gg, Gg, Hhd, Hhd, Hhd, Gs, Hhd, Mm, Mm, Mm, Mm
Hh, Gs, Hhd, Hhd, Mm, Mm, Mm, Mm, Hhd, Gg^Vh, Gg, Rd, Rd, Gs, Gs, Gg, Gs, Gg^Vh, Gs, Gs, Gs, Gs, Rd, Rd, Hh, Hhd, Hhd, Cer, Hh, Hh, Hhd, Gg, Gg, Gg^Vh, Gg, Gs, Gs, Hhd, Mm, Mm, Mm, Mm
Hhd, Gs, Hhd, Mm, Mm, Mm, Mm, Hhd, Gg, Gg, Hh, Hhd, Rd, Gs, Hhd, Gs, Hhd, Gs, Gs, Gs, Hh, Hh, Rd, Hh, Hh, Hhd, Gs, Hhd, Gs, Hh, Hh, Gs, Hhd, Gs, Hh, Gs, Hhd, Gs, Hh, Mm, Mm, Mm
Hh, Gs, Hh, Gs, Gs, Hhd, Gs, Gs, Gg, Gg, Hh, Hhd, Rd, Hh, Gs, Hh, Gs, Hhd, Gs, Gs, Gs, Gs, Hhd, Hh, Hh, Gs, Gs, Hh, Hh, Hh, Mm, Hh, Hh, Gs, Hhd, Hhd, Hh, Hhd, Gs, Hhd, Mm, Mm
Hhd, Hhd, Gs, Gs, Hh, Hh, Hh^Vhh, Hhd, Gs, Hhd, Hh, Hhd, Rd, Hh, Hhd, Hh, Gs, Hh, Gs, Hh, Hhd, Hhd, Hhd, Hh, Hh, Gs, Gs, Hh, Hhd, Mm, Mm, Mm, Hhd, Hhd, Gs, Gs, Hh, Hhd, Gg, Hh, Hh^Vhh, Mm
Hh, Hh, Hhd, Gs, Gs, Gs, Hh, Hhd, Gs, Hhd, Hhd, Hh, Hhd, Hh, Hh, Hh, Hh, Hhd, Hh, Hhd, Rd, Rd, Gs, Gs, Gg, Gg, Gg, Gs, Gg, Hhd, Hhd, Hhd, Gs, Hh, Gs, Hhd, Gg, Gg, Gs, Hhd, Mm, Mm
Gg, Hhd, Hhd, Gs, Hhd, Gs, Gs, Gs, Hhd, Gs, Hh, Hhd, Hhd, Hh, Hhd, Hhd, Hh^Vhh, Hhd, Rd, Rd, Gs, Hh, Gg, Gg, Gg, Gg, Gg, Gg, Gg, Gg, Gs, Gs, Gs, Hhd, Hh, Gs, Gg, Gg, Gs, Hh, Hh, Hh
Gg, Gg, Gs, Hhd, Hhd, Gs, Hh, Gs, Hh, Gs, Cer, Cer, Cer, Hhd, Hh, Hhd, Hhd, Hh, Gs, Gs, Gg, Gg, Gg, Gg, Hh, Gg, Gs, Gs, Gg, Gs, Mm, Gs^Vht, Hhd, Hhd, Gs, Gs, Gs, Gg, Mm^Vhh, Hhd, Mm, Hh
Gg, Gs, Hhd, Hhd, Hhd, Hhd, Hh, Hh, Hhd, Hhd, Cer, 4 Ker, Cer, Hhd, Gs, Hhd, Hh, Hh, Gs, Gs, Gg, Gg, Gs, Gs, Hhd, Hh, Hhd, Mm^Vhh, Mm, Mm, Mm, Mm, Mm, Mm, Mm, Mm, Mm, Mm, Mm, Mm, Mm, Mm
Gg, Gs, Hhd, Hhd, Hh, Hhd, Hh, Hh, Hh, Gs, Hhd, Cer, Hhd, Gs, Hh, Rd, Rd, Hh, Hh, Gs, Gs, Gs, Hhd, Hh, Hhd, Hhd, Hhd, Mm, Mm, Mm, Mm, Mm, Mm, Mm, Mm, Mm, Mm, Mm, Mm, Mm, Mm, Mm
Gg, Gs, Hhd, Hhd, Hhd, Hhd, Gg, Gg, Hh, Hhd, Gs, Gs, Hhd, Gs, Hhd, Hhd, Hh, Rd, Hh, Hhd, Hh, Hhd, Hh, Hh, Hhd, Hh, Hh, Mm, Mm, Mm, Mm, Mm, Mm, Mm, Mm, Mm, Mm, Mm, Mm, Mm, Mm, Mm
Gg, Hh, Hhd, Hhd, Hh, Hhd, Gg, Gg, Gs, Gs, Gs, Gs, Gs^Vht, Gs, Hhd, Hhd, Hhd, Rd, Hh, Hhd, Hh, Hhd, Hh, Hh, Hhd, Hhd, Mm, Mm, Mm, Mm, Mm, Mm, Mm^Vhh, Mm, Mm, Mm, Mm, Mm, Xu, Xu, Xu, Xu
Hhd, Hhd, Hhd, Hhd, Hhd, Hhd, Gg, Gg, Gs, Gs, Gs, Gs, Hh, Hhd, Hhd, Hh, Hhd, Rd, Gs, Hh, Gs^Vht, Hh, Gs, Gs, Cf, Gs, Mm, Mm^Vhh, Mm, Mm, Mm, Mm, Mm, Mm, Mm, Mm, Xu, Xu, Xu, Xu, Xu, Xu
Hhd, Hhd, Hh, Hhd, Hh, Hh, Mm, Gg, Mm, Mm^Vhh, Mm, Hh, Hh, Hh, Gs, Hh, Gs, Gs, Gs, Gs^Vht, Gs, Gs^Vht, Gs, Cf, 2 Kf, Cf, Mm, Mm, Mm, Mm, Mm, Mm, Xu, Xu, Xu, Xu, Xu, Xu, Xu, Xu, Xu, Xu
Hhd, Hhd, Hhd, Hh, Hh, Hh, Mm, Mm, Mm, Mm, Mm, Mm, Cf, Cf, Cf, Gs, Gs, Gs, Uu^Vu, Gs, Uu^Ii, Gs, Uu^Vu, Cf, Cf, Cf, Xu, Mm, Xu, Xu, Xu, Xu, Xu, Xu, Xu, Xu, Xu, Xu, Xu, Xu, Xu, Xu
Hhd, Hh, Mm, Hhd, Mm, Hh, Mm, Mm, Mm, Mm, Mm, Mm, Cf, 3 Kf, Cf, Gs, Re, Uu^Ii, Cf, Cf, Cf, Uu^Ii, Uu^Ii, Uu^Ii, Xu, Xu, Xu, Xu, Xu, Xu, Xu, Xu, Xu, Xu, Xu, Xu, Xu, Xu, Xu, Xu, Xu, Xu
Mm, Mm, Mm, Mm, Mm, Mm, Mm, Mm, Mm, Mm, Mm, Mm, Xu, Cf, Uu^Ii, Uu^Ii, Uu^Ii, Re, Cf, 1 Kf, Cf, Uu^Ii, Uu, Uh^Ii, Xu, Xu, Xu, Xu, Xu, Xu, Xu, Xu, Xu, Xu, Xu, Xu, Xu, Xu, Xu, Xu, Xu, Xu
Mm, Mm, Mm, Mm, Mm, Mm^Vhh, Mm, Mm, Mm, Mm, Xu, Xu, Xu, Xu, Xu, Uu^Ii, Uu, Re, Re, Cf, Uu, Rd, Uu^Vud, Uh, Xu, Xu, Xu, Xu, Xu, Xu, Xu, Xu, Xu, Xu, Xu, Xu, Xu, Xu, Xu, Xu, Xu, Xu
Mm, Mm, Mm, Mm, Mm, Mm, Mm, Mm, Xu, Xu, Xu, Xu, Xu, Xu, Xu, Xu, Xu, Uu, Uu, Re, Uu, Rd, Uu, Uh, Xu, Xu, Xu, Xu, Xu, Xu, Xu, Xu, Xu, Xu, Xu, Xu, Xu, Xu, Xu, Xu, Xu, Xu
Mm, Mm, Mm^Vhh, Mm, Mm, Mm, Mm, Mm, Xu, Xu, Xu, Xu, Xu, Xu, Xu, Xu, Xu, Uu^Vud, Rd, Rd, Uu, Rd, Rd, Uh, Uh, Xu, Xu, Xu, Xu, Xu, Xu, Xu, Xu, Xu, Xu, Xu, Xu, Xu, Xu, Xu, Xu, Xu
Mm, Mm, Mm, Mm, Mm, Mm, Xu, Xu, Xu, Xu, Xu, Xu, Xu, Xu, Xu, Xu, Xu, Xu, Uu, Rd, Uu, Uu, Uu, Uu, Uu, Xu, Xu, Xu, Xu, Xu, Xu, Xu, Xu, Xu, Xu, Xu, Xu, Xu, Xu, Xu, Xu, Xu
Xu, Xu, Xu, Xu, Xu, Xu, Xu, Xu, Xu, Xu, Xu, Xu, Xu, Xu, Xu, Xu, Xu, Xu, Uu, Rd, Rd, Re, Re, Uu, Uu, Re, Re, Xu, Xu, Xu, Xu, Xu, Xu, Xu, Xu, Xu, Xu, Xu, Xu, Xu, Xu, Xu
Xu, Xu, Xu, Xu, Xu, Xu, Xu, Xu, Xu, Xu, Xu, Xu, Xu, Xu, Xu, Xu, Xu, Xu, Xu, Uu^Vu, Uh, Uu, Re, Uu, Uu, Uu, Uu, Uu^Vu, Uu, Uu, Uu, Uu, Uu^Vu, Xu, Xu, Xu, Xu, Xu, Xu, Xu, Xu, Xu
Xu, Xu, Xu, Xu, Xu, Xu, Xu, Xu, Xu, Xu, Xu, Xu, Xu, Xu, Xu, Xu, Xu, Xu, Xu, Uh, Uh, Uh, Uu, Re, Uu, Rd, Uu, Uu, Re, Re, Rd, Uu, Uu, Uh, Xu, Xu, Xu, Xu, Xu, Xu, Xu, Xu
Xu, Xu, Xu, Xu, Xu, Xu, Xu, Xu, Xu, Xu, Xu, Xu, Xu, Xu, Xu, Xu, Xu, Xu, Xu, Xu, Uh, Uh, Uu, Re, Rd, Rd, Rd, Rd, Rd, Uu, Uu, Rd, Uh, Uh, Uh, Xu, Xu, Xu, Xu, Xu, Xu, Xu
Xu, Xu, Xu, Xu, Xu, Xu, Xu, Xu, Xu, Xu, Xu, Xu, Xu, Xu, Xu, Xu, Xu, Xu, Xu, Xu, Xu, Uu^Vud, Uu, Uu, Uu, Uu, Uu, Uu, Uu, Rd, Uu, Rd, Rd, Uh, Uu, Xu, Xu, Xu, Xu, Xu, Xu, Xu
Xu, Xu, Xu, Xu, Xu, Xu, Xu, Xu, Xu, Xu, Xu, Xu, Xu, Xu, Xu, Xu, Xu, Xu, Xu, Xu, Xu, Xu, Xu, Xu, Xu, Xu, Xu, Xu, Xu, Uu, Xu, Uu, Uu^Vu, Rd, Rd, Uu^Vud, Uu, Xu, Xu, Xu, Xu, Xu
Xu, Xu, Xu, Xu, Xu, Xu, Xu, Xu, Xu, Xu, Xu, Xu, Xu, Xu, Xu, Xu, Xu, Xu, Xu, Xu, Xu, Xu, Xu, Xu, Xu, Xu, Xu, Xu, Xu, Xu, Xu, Xu, Uu, Uu, Uu, Uu, Uu, Uu, Uu, Xu, Xu, Xu
