border_size=1
usage=map

Hh          , Hh          , Hh          , Hh          , Gs          , Gg          , Gs          , Hh          , Hh          , Hh          , Hh          , Hh          , Hh          , Hh          , Hh          , Hh          , Hh          , Gs          , Gg          , Gg          , Gs          , Uu          , Gs          , Gs          , Gs          , Gg          , Gg          , Gs          , Hh          , Hh          , Hh          , Hh          , Hh          , Hh          , Hh          , Hh          , Hh          , Hh          , Hh          , Hh          , Hh          , Hh          
Hh          , Hh          , Hh          , Hh          , Gs          , Gs          , Gg          , Gs          , Hh          , Hh          , Gs          , Hh          , Hh          , Hh          , Hh          , Hh          , Hh          , Gs          , Gs          , Gs          , Gg^Vh       , Gs          , Gs          , Gs          , Gs          , Gg          , Gg          , Gs          , Hh          , Hh          , Hh          , Gs          , Gs          , Hh          , Gs          , Hh          , Hh          , Hh          , Hh          , Hh          , Hh          , Hh          
Hh          , Hh          , Hh          , Hh          , Gs          , Gg          , Gg          , Gg          , Gg          , Gs          , Hh          , Hh          , Gs          , Hh          , Hh          , Hh          , Hh          , Hh          , Hh          , Gs          , Gs          , Gs          , Hh          , Gs          , Gs          , Gs          , Gg          , Gs          , Hh          , Gs          , Gs          , Hh          , Hh          , Hh          , Gs          , Hh          , Chr         , Chr         , Chr         , Hh          , Hh          , Hh          
Hh          , Hh          , Gs          , Gs          , Hh          , Gs          , Gg          , Gg^Vh       , Gs          , Hh          , Hh          , Hh          , Hh          , Hh          , Gs          , Hh          , Gs          , Hh          , Hh          , Hh          , Hh          , Hh          , Gs          , Hh          , Gs          , Gs          , Gg          , Gs          , Gs          , Hh          , Gs          , Gs          , Gs          , Hh          , Gs          , Hh          , Chr         , 7 Khr       , Chr         , Gs          , Hh          , Gs          
Hh          , Hh          , Gs          , Hh          , Gs          , Hh          , Mm          , Mm          , Mm          , Mm          , Mm          , Hh          , Hh          , Hh          , Gs          , Hh          , Gs^Vht      , Hh          , Gs          , Hh          , Hh          , Gs          , Hh          , Hh          , Hh          , Gs          , Gs          , Gs          , Hh          , Hh          , Hh          , Hh          , Hh          , Hh          , Hh          , Hh          , Gs          , Chr         , Gs          , Hh          , Hh          , Hh          
Hh          , Hh          , Hh          , Hh          , Hh          , Hh          , Gs          , Mm          , Mm          , Mm          , Mm          , Hh          , Hh          , Gs          , Hh          , Gs          , Hh          , Gs          , Hh          , Hh          , Hh          , Hh          , Hh          , Hh          , Gs          , Gs          , Mm          , Gs          , Gs          , Gs          , Gs          , Hh          , Gs          , Gg^Vh       , Gg          , Gs          , Rd          , Gs          , Hh          , Gs          , Hh          , Gs          
Hh          , Hh          , Hh          , Hh          , Hh          , Hh          , Hh          , Hh          , Mm          , Mm          , Gs          , Hh          , Gs          , Hh          , Gs          , Hh          , Hh          , Hh          , Hh          , Hh          , Hh^Vhh      , Hh          , Hh          , Gs          , Mm          , Mm          , Mm          , Mm          , Gs          , Gs          , Gs          , Hh          , Gs          , Gg          , Rd          , Rd          , Gs          , Hh          , Gs          , Hh          , Mm          , Mm          
Hh          , Hh          , Hh          , Hh          , Gs          , Gs          , Gs          , Gs^Vht      , Hh          , Gs          , Hh          , Hh          , Hh          , Hh          , Hh          , Gs          , Chr         , Chr         , Chr         , Hh          , Hh          , Gs          , Gg          , Gg          , Mm          , Mm          , Mm          , Mm          , Hh          , Gs          , Gs          , Gs          , Rd          , Rd          , Gg          , Gg          , Gs          , Hh          , Hh          , Mm          , Mm          , Mm          
Hh          , Hh          , Hh          , Gs          , Gs          , Gs          , Hh          , Hh          , Hh          , Gs          , Hh          , Hh          , Gs          , Hh          , Hh          , Hh          , Chr         , 6 Khr       , Chr         , Hh          , Gs          , Gs          , Gg          , Gg          , Hh          , Mm          , Hh          , Hh          , Hh          , Hh          , Hh          , Rd          , Gs          , Gs          , Gg          , Gs          , Hh          , Hh          , Hh          , Mm          , Mm          , Mm          
Hh          , Hh          , Hh          , Gs          , Chr         , Hh          , Hh          , Gs          , Hh          , Hh          , Hh          , Gs          , Gs          , Hh          , Hh          , Hh          , Hh          , Chr         , Hh          , Gs          , Gg          , Gg          , Gs          , Gs          , Gs          , Hh          , Hh          , Hh          , Hh^Vhh      , Hh          , Gs          , Rd          , Hh          , Hh          , Gs          , Gs          , Hh          , Gs          , Gg          , Hh          , Gs          , Mm          
Hh          , Hh          , Gs          , Chr         , 8 Khr       , Chr         , Gs          , Rd          , Rd          , Hh          , Gs          , Gs          , Gs          , Hh          , Hh          , Gs          , Rd          , Hh          , Hh          , Gs          , Hh          , Gs          , Gs          , Hh          , Hh          , Gs          , Hh          , Hh          , Hh          , Hh          , Gs          , Rd          , Gs          , Hh          , Hh          , Hh          , Hh          , Gg          , Gg          , Gg          , Gs          , Hh          
Hh          , Gs          , Hh          , Chr         , Chr         , Chr         , Hh          , Rd          , Rd          , Gs          , Hh          , Hh          , Gs          , Hh          , Rd          , Rd          , Rd          , Hh          , Hh          , Hh          , Hh          , Hh          , Gs          , Hh          , Gs          , Hh          , Hh          , Hh          , Hh          , Hh          , Hh          , Rd          , Gs          , Gs          , Gs          , Gs          , Gs          , Gs          , Hh          , Gs          , Mm          , Mm          
Hh          , Gs          , Hh          , Hh          , Hh          , Hh          , Gs          , Hh          , Rd          , Hh          , Gs          , Hh          , Gs          , Hh          , Rd          , Rd          , Gs          , Hh          , Gs          , Hh          , Gs          , Hh          , Gs          , Hh          , Gs          , Hh          , Hh          , Hh          , Hh          , Hh          , Hh          , Rd          , Hh          , Hh          , Hh          , Gs          , Hh          , Hh          , Hh          , Mm          , Mm          , Mm          
Hh          , Gs          , Gs          , Hh          , Gs          , Gs          , Hh          , Mm          , Hh          , Hh          , Gg          , Hh          , Hh          , Rd          , Gs          , Gs          , Gg          , Gs          , Gs          , Hh          , Gs          , Gs          , Gs          , Hh          , Gs          , Hh          , Chr         , Chr         , Chr         , Gs          , Gs          , Gg          , Gs          , Hh          , Gs          , Hh          , Gs          , Hh          , Mm          , Mm          , Mm          , Mm          
Hh          , Hh          , Hh          , Gs          , Gs          , Gs          , Mm          , Mm          , Gs          , Rd          , Rd          , Gs          , Hh          , Gs          , Gg          , Gg          , Gg          , Gs          , Gs          , Gs          , Gs^Vht      , Gs          , Gs          , Gs          , Rd          , Hh          , Chr         , 5 Khr       , Chr         , Hh          , Gs          , Gg          , Gg          , Hh          , Hh          , Hh          , Gs          , Hh          , Mm          , Mm          , Mm          , Mm          
Hh          , Gs          , Hh          , Hh          , Mm          , Mm          , Mm          , Mm          , Hh          , Gg^Vh       , Gg          , Rd          , Rd          , Gs          , Gs          , Gg          , Gs          , Gg^Vh       , Gs          , Gs          , Gs          , Gs          , Rd          , Rd          , Hh          , Hh          , Hh          , Chr         , Hh          , Hh          , Hh          , Gg          , Gg          , Gg^Vh       , Gg          , Gs          , Gs          , Hh          , Mm          , Mm          , Mm          , Mm          
Hh          , Gs          , Hh          , Mm          , Mm          , Mm          , Mm          , Hh          , Gg          , Gg          , Hh          , Hh          , Rd          , Gs          , Hh          , Gs          , Hh          , Gs          , Gs          , Gs          , Hh          , Hh          , Rd          , Hh          , Hh          , Hh          , Gs          , Hh          , Gs          , Hh          , Hh          , Gs          , Hh          , Gs          , Hh          , Gs          , Hh          , Gs          , Hh          , Mm          , Mm          , Mm          
Hh          , Gs          , Hh          , Gs          , Gs          , Hh          , Gs          , Gs          , Gg          , Gg          , Hh          , Hh          , Rd          , Hh          , Gs          , Hh          , Gs          , Hh          , Gs          , Gs          , Gs          , Gs          , Hh          , Hh          , Hh          , Gs          , Gs          , Hh          , Hh          , Hh          , Mm          , Hh          , Hh          , Gs          , Hh          , Hh          , Hh          , Hh          , Gs          , Hh          , Mm          , Mm          
Hh          , Hh          , Gs          , Gs          , Hh          , Hh          , Hh^Vhh      , Hh          , Gs          , Hh          , Hh          , Hh          , Rd          , Hh          , Hh          , Hh          , Gs          , Hh          , Gs          , Hh          , Hh          , Hh          , Hh          , Hh          , Hh          , Gs          , Gs          , Hh          , Hh          , Mm          , Mm          , Mm          , Hh          , Hh          , Gs          , Gs          , Hh          , Hh          , Gg          , Hh          , Hh^Vhh      , Mm          
Hh          , Hh          , Hh          , Gs          , Gs          , Gs          , Hh          , Hh          , Gs          , Hh          , Hh          , Hh          , Hh          , Hh          , Hh          , Hh          , Hh          , Hh          , Hh          , Hh          , Rd          , Rd          , Gs          , Gs          , Gg          , Gg          , Gg          , Gs          , Gg          , Hh          , Hh          , Hh          , Gs          , Hh          , Gs          , Hh          , Gg          , Gg          , Gs          , Hh          , Mm          , Mm          
Gg          , Hh          , Hh          , Gs          , Hh          , Gs          , Gs          , Gs          , Hh          , Gs          , Hh          , Hh          , Hh          , Hh          , Hh          , Hh          , Hh^Vhh      , Hh          , Rd          , Rd          , Gs          , Hh          , Gg          , Gg          , Gg          , Gg          , Gg          , Gg          , Gg          , Gg          , Gs          , Gs          , Gs          , Hh          , Hh          , Gs          , Gg          , Gg          , Gs          , Hh          , Hh          , Hh          
Gg          , Gg          , Gs          , Hh          , Hh          , Gs          , Hh          , Gs          , Hh          , Gs          , Chr         , Chr         , Chr         , Hh          , Hh          , Hh          , Hh          , Hh          , Gs          , Gs          , Gg          , Gg          , Gg          , Gg          , Hh          , Gg          , Gs          , Gs          , Gg          , Gs          , Mm          , Gs^Vht      , Hh          , Hh          , Gs          , Gs          , Gs          , Gg          , Mm^Vhh      , Hh          , Mm          , Hh          
Gg          , Gs          , Hh          , Hh          , Hh          , Hh          , Hh          , Hh          , Hh          , Hh          , Chr         , 4 Khr       , Chr         , Hh          , Gs          , Hh          , Hh          , Hh          , Gs          , Gs          , Gg          , Gg          , Gs          , Gs          , Hh          , Hh          , Hh          , Mm^Vhh      , Mm          , Mm          , Mm          , Mm          , Mm          , Mm          , Mm          , Mm          , Mm          , Mm          , Mm          , Mm          , Mm          , Mm          
Gg          , Gs          , Hh          , Hh          , Hh          , Hh          , Hh          , Hh          , Hh          , Gs          , Hh          , Chr         , Hh          , Gs          , Hh          , Rd          , Rd          , Hh          , Hh          , Gs          , Gs          , Gs          , Hh          , Hh          , Hh          , Hh          , Hh          , Mm          , Mm          , Mm          , Mm          , Mm          , Mm          , Mm          , Mm          , Mm          , Mm          , Mm          , Mm          , Mm          , Mm          , Mm          
Gg          , Gs          , Hh          , Hh          , Hh          , Hh          , Gg          , Gg          , Hh          , Hh          , Gs          , Gs          , Hh          , Gs          , Hh          , Hh          , Hh          , Rd          , Hh          , Hh          , Hh          , Hh          , Hh          , Hh          , Hh          , Hh          , Hh          , Mm          , Mm          , Mm          , Mm          , Mm          , Mm          , Mm          , Mm          , Mm          , Mm          , Mm          , Mm          , Mm          , Mm          , Mm          
Gg          , Hh          , Hh          , Hh          , Hh          , Hh          , Gg          , Gg          , Gs          , Gs          , Gs          , Gs          , Gs^Vht      , Gs          , Hh          , Hh          , Hh          , Rd          , Hh          , Hh          , Hh          , Hh          , Hh          , Hh          , Hh          , Hh          , Mm          , Mm          , Mm          , Mm          , Mm          , Mm          , Mm^Vhh      , Mm          , Mm          , Mm          , Mm          , Mm          , Xu          , Xu          , Xu          , Xu          
Hh          , Hh          , Hh          , Hh          , Hh          , Hh          , Gg          , Gg          , Gs          , Gs          , Gs          , Gs          , Hh          , Hh          , Hh          , Hh          , Hh          , Rd          , Gs          , Hh          , Gs^Vht      , Hh          , Gs          , Gs          , Cud         , Gs          , Mm          , Mm^Vhh      , Mm          , Mm          , Mm          , Mm          , Mm          , Mm          , Mm          , Mm          , Xu          , Xu          , Xu          , Xu          , Xu          , Xu          
Hh          , Hh          , Hh          , Hh          , Hh          , Hh          , Mm          , Gg          , Mm          , Mm^Vhh      , Mm          , Hh          , Hh          , Hh          , Gs          , Hh          , Gs          , Gs          , Gs          , Gs^Vht      , Gs          , Gs^Vht      , Gs          , Cud         , 2 Kud       , Cud         , Mm          , Mm          , Mm          , Mm          , Mm          , Mm          , Xu          , Xu          , Xu          , Xu          , Xu          , Xu          , Xu          , Xu          , Xu          , Xu          
Hh          , Hh          , Hh          , Hh          , Hh          , Hh          , Mm          , Mm          , Mm          , Mm          , Mm          , Mm          , Cud         , Cud         , Cud         , Gs          , Gs          , Gs          , Uu^Vu       , Gs          , Uu^Ii       , Gs          , Uu^Vu       , Cud         , Cud         , Cud         , Xu          , Mm          , Xu          , Xu          , Xu          , Xu          , Xu          , Xu          , Xu          , Xu          , Xu          , Xu          , Xu          , Xu          , Xu          , Xu          
Hh          , Hh          , Mm          , Hh          , Mm          , Hh          , Mm          , Mm          , Mm          , Mm          , Mm          , Mm          , Cud         , 3 Kud       , Cud         , Gs          , Re          , Uu^Ii       , Cud         , Cud         , Cud         , Uu^Ii       , Uu^Ii       , Uu^Ii       , Xu          , Xu          , Xu          , Xu          , Xu          , Xu          , Xu          , Xu          , Xu          , Xu          , Xu          , Xu          , Xu          , Xu          , Xu          , Xu          , Xu          , Xu          
Mm          , Mm          , Mm          , Mm          , Mm          , Mm          , Mm          , Mm          , Mm          , Mm          , Mm          , Mm          , Xu          , Cud         , Uu^Ii       , Uu^Ii       , Uu^Ii       , Re          , Cud         , 1 Kud       , Cud         , Uu^Ii       , Uu          , Uh^Ii       , Xu          , Xu          , Xu          , Xu          , Xu          , Xu          , Xu          , Xu          , Xu          , Xu          , Xu          , Xu          , Xu          , Xu          , Xu          , Xu          , Xu          , Xu          
Mm          , Mm          , Mm          , Mm          , Mm          , Mm^Vhh      , Mm          , Mm          , Mm          , Mm          , Xu          , Xu          , Xu          , Xu          , Xu          , Uu^Ii       , Uu          , Re          , Re          , Cud         , Uu          , Rd          , Uu^Vud      , Uh          , Xu          , Xu          , Xu          , Xu          , Xu          , Xu          , Xu          , Xu          , Xu          , Xu          , Xu          , Xu          , Xu          , Xu          , Xu          , Xu          , Xu          , Xu          
Mm          , Mm          , Mm          , Mm          , Mm          , Mm          , Mm          , Mm          , Xu          , Xu          , Xu          , Xu          , Xu          , Xu          , Xu          , Xu          , Xu          , Uu          , Uu          , Re          , Uu          , Rd          , Uu          , Uh          , Xu          , Xu          , Xu          , Xu          , Xu          , Xu          , Xu          , Xu          , Xu          , Xu          , Xu          , Xu          , Xu          , Xu          , Xu          , Xu          , Xu          , Xu          
Mm          , Mm          , Mm^Vhh      , Mm          , Mm          , Mm          , Mm          , Mm          , Xu          , Xu          , Xu          , Xu          , Xu          , Xu          , Xu          , Xu          , Xu          , Uu^Vud      , Rd          , Rd          , Uu          , Rd          , Rd          , Uh          , Uh          , Xu          , Xu          , Xu          , Xu          , Xu          , Xu          , Xu          , Xu          , Xu          , Xu          , Xu          , Xu          , Xu          , Xu          , Xu          , Xu          , Xu          
Mm          , Mm          , Mm          , Mm          , Mm          , Mm          , Xu          , Xu          , Xu          , Xu          , Xu          , Xu          , Xu          , Xu          , Xu          , Xu          , Xu          , Xu          , Uu          , Rd          , Uu          , Uu          , Uu          , Uu          , Uu          , Xu          , Xu          , Xu          , Xu          , Xu          , Xu          , Xu          , Xu          , Xu          , Xu          , Xu          , Xu          , Xu          , Xu          , Xu          , Xu          , Xu          
Xu          , Xu          , Xu          , Xu          , Xu          , Xu          , Xu          , Xu          , Xu          , Xu          , Xu          , Xu          , Xu          , Xu          , Xu          , Xu          , Xu          , Xu          , Uu          , Rd          , Rd          , Re          , Re          , Uu          , Uu          , Re          , Re          , Xu          , Xu          , Xu          , Xu          , Xu          , Xu          , Xu          , Xu          , Xu          , Xu          , Xu          , Xu          , Xu          , Xu          , Xu          
Xu          , Xu          , Xu          , Xu          , Xu          , Xu          , Xu          , Xu          , Xu          , Xu          , Xu          , Xu          , Xu          , Xu          , Xu          , Xu          , Xu          , Xu          , Xu          , Uu^Vu       , Uh          , Uu          , Re          , Uu          , Uu          , Uu          , Uu          , Uu^Vu       , Uu          , Uu          , Uu          , Uu          , Uu^Vu       , Xu          , Xu          , Xu          , Xu          , Xu          , Xu          , Xu          , Xu          , Xu          
Xu          , Xu          , Xu          , Xu          , Xu          , Xu          , Xu          , Xu          , Xu          , Xu          , Xu          , Xu          , Xu          , Xu          , Xu          , Xu          , Xu          , Xu          , Xu          , Uh          , Uh          , Uh          , Uu          , Re          , Uu          , Rd          , Uu          , Uu          , Re          , Re          , Rd          , Uu          , Uu          , Uh          , Xu          , Xu          , Xu          , Xu          , Xu          , Xu          , Xu          , Xu          
Xu          , Xu          , Xu          , Xu          , Xu          , Xu          , Xu          , Xu          , Xu          , Xu          , Xu          , Xu          , Xu          , Xu          , Xu          , Xu          , Xu          , Xu          , Xu          , Xu          , Uh          , Uh          , Uu          , Re          , Rd          , Rd          , Rd          , Rd          , Rd          , Uu          , Uu          , Rd          , Uh          , Uh          , Uh          , Xu          , Xu          , Xu          , Xu          , Xu          , Xu          , Xu          
Xu          , Xu          , Xu          , Xu          , Xu          , Xu          , Xu          , Xu          , Xu          , Xu          , Xu          , Xu          , Xu          , Xu          , Xu          , Xu          , Xu          , Xu          , Xu          , Xu          , Xu          , Uu^Vud      , Uu          , Uu          , Uu          , Uu          , Uu          , Uu          , Uu          , Rd          , Uu          , Rd          , Rd          , Uh          , Uu          , Xu          , Xu          , Xu          , Xu          , Xu          , Xu          , Xu          
Xu          , Xu          , Xu          , Xu          , Xu          , Xu          , Xu          , Xu          , Xu          , Xu          , Xu          , Xu          , Xu          , Xu          , Xu          , Xu          , Xu          , Xu          , Xu          , Xu          , Xu          , Xu          , Xu          , Xu          , Xu          , Xu          , Xu          , Xu          , Xu          , Uu          , Xu          , Uu          , Uu^Vu       , Rd          , Rd          , Uu^Vud      , Uu          , Xu          , Xu          , Xu          , Xu          , Xu          
Xu          , Xu          , Xu          , Xu          , Xu          , Xu          , Xu          , Xu          , Xu          , Xu          , Xu          , Xu          , Xu          , Xu          , Xu          , Xu          , Xu          , Xu          , Xu          , Xu          , Xu          , Xu          , Xu          , Xu          , Xu          , Xu          , Xu          , Xu          , Xu          , Xu          , Xu          , Xu          , Uu          , Uu          , Uu          , Uu          , Uu          , Uu          , Uu          , Xu          , Xu          , Xu          
