Hhd, Hhd, Hhd, Hhd, Gd, Gg, Gd, Hhd, Hhd, Hhd, Hhd, Hhd, Hhd, Hhd, Hhd, Hhd, Hhd, Gd, Gs, Gs, Gd, Uu, Gd, Gd, Gd, Gs, Gs, Gd, Hhd, Hhd, Hhd, Hhd, Hhd, Hhd, Hhd, Hhd, Hhd, Hhd, Hhd, Hhd, Hhd, Hhd
Hhd, Hhd, Hhd, Hhd, Gd, Gd, Gs, Gd, Hhd, Hhd, Gd, Hhd, Hhd, Hhd, Hhd, Hhd, Hhd, Gd, Gd, Gd, Gd^Vh, Gd, Gd, Gd, Gd, Gs, Gs, Gd, Hhd, Hhd, Hhd, Gd, Gd, Hhd, Gd, Hhd, Hhd, Hhd, Hhd, Hhd, Hhd, Hhd
Hhd, Hhd, Hhd, Hhd, Gd, Gs, Gs, Gs, Gs, Gd, Hhd, Hhd, Gd, Hhd, Hhd, Hhd, Hhd, Hhd, Hhd, Gd, Gd, Gd, Hhd, Gd, Gd, Gd, Gs, Gd, Hhd, Gd, Gd, Hhd, Hhd, Hhd, Gd, Hhd, Cer, Cer, Cer, Hhd, Hhd, Hhd
Hhd, Hhd, Gd, Gd, Hhd, Gd, Gs, Gs^Vh, Gs, Hhd, Hhd, Hhd, Hhd, Hhd, Gd, Hhd, Gd, Hhd, Hhd, Hhd, Hhd, Hhd, Gd, Hhd, Gd, Gd, Gs, Gd, Gd, Hhd, Gd, Gd, Gd, Hhd, Gd, Hhd, Cer, 7 Ker, Cer, Gd, Hhd, Gs
Hhd, Hhd, Gd, Hhd, Gd, Hhd, Md, Md, Md, Md, Md, Hhd, Hhd, Hhd, Gd, Hhd, Gd^Vht, Hhd, Gd, Hhd, Hhd, Gd, Hhd, Hhd, Hhd, Gd, Gd, Gd, Hhd, Hhd, Hhd, Hhd, Hhd, Hhd, Hhd, Hhd, Gd, Cer, Gd, Hhd, Hhd, Hhd
Hhd, Hhd, Hhd, Hhd, Hhd, Hhd, Gd, Md, Md, Md, Md, Hhd, Hhd, Gd, Hhd, Gd, Hhd, Gd, Hhd, Hhd, Hhd, Hhd, Hhd, Hhd, Gd, Gd, Md, Gd, Gd, Gd, Gd, Hhd, Gd, Gs^Vh, Gs, Gd, Re, Gd, Hhd, Gd, Hhd, Gs
Hhd, Hhd, Hhd, Hhd, Hhd, Hhd, Hhd, Hhd, Md, Md, Gd, Hhd, Gd, Hhd, Gd, Hhd, Hhd, Hhd, Hhd, Hhd, Hhd^Vhh, Hhd, Hhd, Gd, Md, Md, Md, Md, Gd, Gd, Gd, Hhd, Gd, Gs, Re, Re, Gd, Hhd, Gd, Hhd, Md, Md
Hhd, Hhd, Hhd, Hhd, Gd, Gd, Gd, Gd^Vht, Hhd, Gd, Hhd, Hhd, Hhd, Hhd, Hhd, Gd, Cte, Cte, Cte, Hhd, Hhd, Gd, Gs, Gs, Md, Md, Md, Md, Hhd, Gd, Gd, Gd, Re, Re, Gs, Gs, Gd, Hhd, Hhd, Md, Md, Md
Hhd, Hhd, Hhd, Gd, Gd, Gd, Hhd, Hhd, Hhd, Gd, Hhd, Hhd, Gd, Hhd, Hhd, Hhd, Cte, 6 Kte, Cte, Hhd, Gd, Gd, Gs, Gs, Hhd, Md, Hhd, Hhd, Hhd, Hhd, Hhd, Re, Gd, Gd, Gs, Gd, Hhd, Hhd, Hhd, Md, Md, Md
Hhd, Hhd, Hhd, Gd, Cer, Hhd, Hhd, Gd, Hhd, Hhd, Hhd, Gd, Gd, Hhd, Hhd, Hhd, Hhd, Cte, Hhd, Gd, Gs, Gs, Gd, Gd, Gd, Hhd, Hhd, Hhd, Hhd^Vhh, Hhd, Gd, Re, Hhd, Hhd, Gd, Gd, Hhd, Gd, Gs, Hhd, Gd, Md
Hhd, Hhd, Gd, Cer, 8 Ker, Cer, Gd, Re, Re, Hhd, Gd, Gd, Gd, Hhd, Hhd, Gd, Re, Hhd, Hhd, Gd, Hhd, Gd, Gd, Hhd, Hhd, Gd, Hhd, Hhd, Hhd, Hhd, Gd, Re, Gd, Hhd, Hhd, Hhd, Hhd, Gs, Gs, Gs, Gd, Hhd
Hhd, Gd, Hhd, Cer, Cer, Cer, Hhd, Re, Re, Gd, Hhd, Hhd, Gd, Hhd, Re, Re, Re, Hhd, Hhd, Hhd, Hhd, Hhd, Gd, Hhd, Gd, Hhd, Hhd, Hhd, Hhd, Hhd, Hhd, Re, Gd, Gd, Gd, Gd, Gd, Gd, Hhd, Gd, Md, Md
Hhd, Gd, Hhd, Hhd, Hhd, Hhd, Gd, Hhd, Re, Hhd, Gd, Hhd, Gd, Hhd, Re, Re, Gd, Hhd, Gd, Hhd, Gd, Hhd, Gd, Hhd, Gd, Hhd, Hhd, Hhd, Hhd, Hhd, Hhd, Re, Hhd, Hhd, Hhd, Gd, Hhd, Hhd, Hhd, Md, Md, Md
Hhd, Gd, Gd, Hhd, Gd, Gd, Hhd, Md, Hhd, Hhd, Gs, Hhd, Hhd, Re, Gd, Gd, Gs, Gd, Gd, Hhd, Gd, Gd, Gd, Hhd, Gd, Hhd, Cer, Cer, Cer, Gd, Gd, Gs, Gd, Hhd, Gd, Hhd, Gd, Hhd, Md, Md, Md, Md
Hhd, Hhd, Hhd, Gd, Gd, Gd, Md, Md, Gd, Re, Re, Gd, Hhd, Gd, Gs, Gs, Gs, Gd, Gd, Gd, Gd^Vht, Gd, Gd, Gd, Re, Hhd, Cer, 5 Ker, Cer, Hhd, Gd, Gs, Gs, Hhd, Hhd, Hhd, Gd, Hhd, Md, Md, Md, Md
Hhd, Gd, Hhd, Hhd, Md, Md, Md, Md, Hhd, Gs^Vh, Gs, Re, Re, Gd, Gd, Gs, Gd, Gd^Vh, Gd, Gd, Gd, Gd, Re, Re, Hhd, Hhd, Hhd, Cer, Hhd, Hhd, Hhd, Gs, Gs, Gd^Vh, Gs, Gd, Gd, Hhd, Md, Md, Md, Md
Hhd, Gd, Hhd, Md, Md, Md, Md, Hhd, Gs, Gs, Hhd, Hhd, Re, Gd, Hhd, Gd, Hhd, Gd, Gd, Gd, Hhd, Hhd, Re, Hhd, Hhd, Hhd, Gd, Hhd, Gs, Hhd, Hhd, Gd, Hhd, Gd, Hhd, Gd, Hhd, Gd, Hhd, Md, Md, Md
Hhd, Gd, Hhd, Gd, Gd, Hhd, Gd, Gd, Gs, Gs, Hhd, Hhd, Re, Hhd, Rb, Hhd, Rb, Hhd, Gd, Gd, Gd, Gd, Hhd, Hhd, Hhd, Gd, Gd, Hhd, Hhd, Hhd, Md, Hhd, Hhd, Gd, Hhd, Hhd, Hhd, Hhd, Gd, Hhd, Md, Md
Hhd, Hhd, Gd, Gd, Hhd, Hhd, Hhd^Vhh, Hhd, Gd, Hhd, Hhd, Hhd, Re, Hhd, Hhd, Hhd, Rb, Hhd, Gd, Hhd, Hhd, Hhd, Hhd, Hhd, Hhd, Gd, Gd, Hhd, Hhd, Md, Md, Md, Hhd, Hhd, Gd, Gd, Hhd, Hhd, Gs, Hhd, Hhd^Vhh, Md
Hhd, Hhd, Hhd, Gd, Gd, Gd, Hhd, Hhd, Gd, Hhd, Hhd, Hhd, Hhd, Hhd, Hhd, Hhd, Hhd, Hhd, Hhd, Hhd, Re, Re, Gd, Gd, Gs, Gs, Gs, Gd, Gs, Hhd, Hhd, Hhd, Gd, Hhd, Gd, Hhd, Gs, Gs, Gd, Hhd, Md, Md
Gs, Hhd, Hhd, Gd, Hhd, Gd, Gd, Gd, Hhd, Gd, Hhd, Hhd, Hhd, Hhd, Hhd, Hhd, Hhd^Vhh, Hhd, Re, Re, Gd, Hhd, Gs, Gs, Gs, Gs, Gs, Gs, Gs, Gs, Gd, Gd, Gd, Hhd, Hhd, Gd, Gs, Gs, Gd, Hhd, Hhd, Hhd
Gs, Gs, Gd, Hhd, Hhd, Gd, Hhd, Gd, Hhd, Gd, Cer, Cer, Cer, Hhd, Hhd, Hhd, Hhd, Hhd, Gd, Gd, Gs, Gs, Gs, Gs, Hhd, Gs, Gd, Gd, Gs, Gd, Md, Gd^Vht, Hhd, Hhd, Gd, Gd, Gd, Gs, Md^Vhh, Hhd, Md, Hhd
Gs, Gd, Hhd, Hhd, Hhd, Hhd, Md, Hhd, Hhd, Hhd, Cer, 4 Ker, Cer, Hhd, Gd, Hhd, Hhd, Hhd, Gd, Gd, Gs, Gs, Gd, Gd, Hhd, Hhd, Hhd, Md^Vhh, Md, Md, Md, Md, Md, Md, Md, Md, Md, Md, Md, Md, Md, Md
Gs, Gd, Hhd, Hhd, Hhd, Md, Md, Hhd, Hhd, Gd, Hhd, Cer, Hhd, Gd, Hhd, Re, Re, Hhd, Hhd, Gd, Gd, Gd, Hhd, Hhd, Hhd, Hhd, Md, Md, Md, Md, Md, Md, Md, Md, Md, Md, Md, Md, Md, Md, Md, Md
Gs, Gd, Hhd, Hhd, Hhd, Md, Md, Gd, Hhd, Hhd, Gd, Gd, Hhd, Gd, Hhd, Hhd, Hhd, Re, Hhd, Hhd, Hhd, Hhd, Hhd, Hhd, Hhd, Hhd, Hhd, Md, Md, Md, Md, Md, Md, Md, Md, Md, Md, Md, Md, Md, Md, Md
Gs, Hhd, Hhd, Hhd, Md, Md, Md, Md, Gd, Gd, Gd, Gd, Gd^Vht, Gd, Hhd, Hhd, Hhd, Re, Hhd, Hhd, Hhd, Hhd, Hhd, Hhd, Hhd, Hhd, Md, Md, Md, Md, Md, Md, Md^Vhh, Md, Md, Md, Md, Md, Xu, Xu, Xu, Xu
Hhd, Hhd, Hhd, Hhd, Hhd, Md, Hhd, Md, Gd, Gd, Gd, Gd, Hhd, Hhd, Hhd, Hhd, Hhd, Re, Gd, Hhd, Gd^Vht, Hhd, Gd, Gd, Cf, Gd, Md, Md^Vhh, Md, Md, Md, Md, Md, Md, Md, Md, Xu, Xu, Xu, Xu, Xu, Xu
Hhd, Hhd, Hhd, Hhd, Hhd, Hhd, Md, Hhd, Md, Md^Vhh, Md, Hhd, Hhd, Hhd, Gd, Hhd, Gd, Gd, Gd, Gd^Vht, Gd, Gd^Vht, Gd, Cf, 2 Kf, Cf, Md, Md, Md, Md, Md, Md, Xu, Xu, Xu, Xu, Xu, Xu, Xu, Xu, Xu, Xu
Hhd, Hhd, Hhd, Hhd, Hhd, Hhd, Md, Md, Md, Md, Md, Md, Cf, Cf, Cf, Gd, Gd, Gd, Uu^Vu, Gd, Uu^Ii, Gd, Uu^Vu, Cf, Cf, Cf, Xu, Md, Xu, Xu, Xu, Xu, Xu, Xu, Xu, Xu, Xu, Xu, Xu, Xu, Xu, Xu
Hhd, Hhd, Md, Hhd, Md, Hhd, Md, Md, Md, Md, Md, Md, Cf, 3 Kf, Cf, Gd, Re, Uu^Ii, Cf, Cf, Cf, Uu^Ii, Uu^Ii, Uu^Ii, Xu, Xu, Xu, Xu, Xu, Xu, Xu, Xu, Xu, Xu, Xu, Xu, Xu, Xu, Xu, Xu, Xu, Xu
Md, Md, Md, Md, Md, Md, Md, Md, Md, Md, Md, Md, Xu, Cf, Uu^Ii, Uu^Ii, Uu^Ii, Re, Cf, 1 Kf, Cf, Uu^Ii, Uu, Uh^Ii, Xu, Xu, Xu, Xu, Xu, Xu, Xu, Xu, Xu, Xu, Xu, Xu, Xu, Xu, Xu, Xu, Xu, Xu
Md, Md, Md, Md, Md, Md^Vhh, Md, Md, Md, Md, Xu, Xu, Xu, Xu, Xu, Uu^Ii, Uu, Re, Re, Cf, Uu, Rd, Uu^Vud, Uh, Xu, Xu, Xu, Xu, Xu, Xu, Xu, Xu, Xu, Xu, Xu, Xu, Xu, Xu, Xu, Xu, Xu, Xu
Md, Md, Md, Md, Md, Md, Md, Md, Xu, Xu, Xu, Xu, Xu, Xu, Xu, Xu, Xu, Uu^Ebn, Uu, Re, Uu, Rd, Uu, Uh, Xu, Xu, Xu, Xu, Xu, Xu, Xu, Xu, Xu, Xu, Xu, Xu, Xu, Xu, Xu, Xu, Xu, Xu
Md, Md, Md^Vhh, Md, Md, Md, Md, Md, Xu, Xu, Xu, Xu, Xu, Xu, Xu, Xu, Xu, Uu^Vud, Rd, Rd, Uu, Rd, Rd, Uh, Uh, Xu, Xu, Xu, Xu, Xu, Xu, Xu, Xu, Xu, Xu, Xu, Xu, Xu, Xu, Xu, Xu, Xu
Md, Md, Md, Md, Md, Md, Xu, Xu, Xu, Xu, Xu, Xu, Xu, Xu, Xu, Xu, Xu, Xu, Uu, Rd, Uu, Uu, Uu, Uu^Ebn, Uu, Xu, Xu, Xu, Xu, Xu, Xu, Xu, Xu, Xu, Xu, Xu, Xu, Xu, Xu, Xu, Xu, Xu
Xu, Xu, Xu, Xu, Xu, Xu, Xu, Xu, Xu, Xu, Xu, Xu, Xu, Xu, Xu, Xu, Xu, Xu, Uu, Rd, Rd, Re, Re, Uu, Uu, Re, Re, Xu, Xu, Xu, Xu, Xu, Xu, Xu, Xu, Xu, Xu, Xu, Xu, Xu, Xu, Xu
Xu, Xu, Xu, Xu, Xu, Xu, Xu, Xu, Xu, Xu, Xu, Xu, Xu, Xu, Xu, Xu, Xu, Xu, Xu, Uu^Vu, Uh, Uu, Re, Uu, Uu, Uu, Uu, Uu^Vu, Uu, Uu, Uu^Ebn, Uu, Uu^Vu, Xu, Xu, Xu, Xu, Xu, Xu, Xu, Xu, Xu
Xu, Xu, Xu, Xu, Xu, Xu, Xu, Xu, Xu, Xu, Xu, Xu, Xu, Xu, Xu, Xu, Xu, Xu, Xu, Uh, Uh, Uh, Uu, Re, Uu, Rd, Uu, Uu, Re, Re, Rd, Uu, Uu, Uh, Xu, Xu, Xu, Xu, Xu, Xu, Xu, Xu
Xu, Xu, Xu, Xu, Xu, Xu, Xu, Xu, Xu, Xu, Xu, Xu, Xu, Xu, Xu, Xu, Xu, Xu, Xu, Xu, Uh, Uh, Uu^Ebn, Re, Rd, Rd, Rd, Rd, Rd, Uu, Uu, Rd, Uh, Uh, Uh, Xu, Xu, Xu, Xu, Xu, Xu, Xu
Xu, Xu, Xu, Xu, Xu, Xu, Xu, Xu, Xu, Xu, Xu, Xu, Xu, Xu, Xu, Xu, Xu, Xu, Xu, Xu, Xu, Uu^Vud, Uu, Uu, Uu, Uu, Uu, Uu, Uu, Rd, Uu, Rd, Rd, Uh, Uu, Xu, Xu, Xu, Xu, Xu, Xu, Xu
Xu, Xu, Xu, Xu, Xu, Xu, Xu, Xu, Xu, Xu, Xu, Xu, Xu, Xu, Xu, Xu, Xu, Xu, Xu, Xu, Xu, Xu, Xu, Xu, Xu, Xu, Xu, Xu, Xu, Uu, Xu, Uu^Ebn, Uu^Vu, Rd, Rd, Uu^Vud, Uu, Xu, Xu, Xu, Xu, Xu
Xu, Xu, Xu, Xu, Xu, Xu, Xu, Xu, Xu, Xu, Xu, Xu, Xu, Xu, Xu, Xu, Xu, Xu, Xu, Xu, Xu, Xu, Xu, Xu, Xu, Xu, Xu, Xu, Xu, Xu, Xu, Xu, Uu, Uu, Uu, Uu, Uu, Uu, Uu, Xu, Xu, Xu
