Wo, Wo, Wo, Wo, Wo, Wo, Wo, Ww, Wo, Ww, Ww, Ww, Ww, Ww, Ww, Ww, Ww, Ww, Ww, Ww, Ww, Ww, Ww, Ww, Ww, Ww, Ww, Ww, Wo, Wo, Wo, Wo, Wo, Ww, Wo, Wo, Wo, Ww, Ww, Ww, Wo, Wo, Ww, Ww, Mm, Ww, Ds, Gg, Mm, Mm, Mm, Mm, Mm, Mm, Mm, Mm, Mm, Mm, Mm, Mm, Mm, Mm, Mm, Mm, Mm, Mm, Mm, Mm, Mm, Mm, Mm, Ww
Ww, Wo, Ww, Wo, Wo, Wo, Wo, Wo, Wo, Wo, Wo, Wo, Wo, Wo, Wo, Ww, Wo, Wo, Wo, Ww, Wo, Ww, Wo, Ww, Wo, Wo, Wo, Wo, Ww, Wo, Ww, Wo, Ww, Wo, Ww, Ww, Ww, Ww, Ww, Wo, Ww, Ww, Mm, Mm^Xm, Mm^Xm, Mm, Mm, Mm, Mm, Mm, Mm, Mm, Mm, Mm, Mm, Mm, Mm, Mm, Mm, Mm, Mm, Mm, Mm, Mm, Mm, Mm, Mm, Mm, Mm, Mm, Mm, Mm
Ww, Ww, Ww, Ww, Ww, Ww, Ww, Ww, Ww, Wo, Ww, Wo, Ww, Wo, Wo, Wo, Wo, Wo, Wo, Wo, Wo, Wo, Ww, Wo, Ww, Wo, Ww, Ww, Ww, Ww, Ww, Ww, Ww, Ww, Ww, Ww, Ds, Ww, Ds, Ww, Ds, Ds, Mm, Mm, Mm, Mm^Xm, Mm^Xm, Mm, Mm, Mm, Mm, Mm, Mm^Xm, Mm, Mm, Mm, Mm, Mm, Mm, Mm, Mm, Mm, Mm, Mm, Mm, Mm, Mm, Mm, Mm, Mm, Mm, Mm
Ww, Ww, Ww, Ww, Ww, Ww, Ww, Ww, Ww, Ww, Ww, Ww, Ww, Ww, Ww, Ww, Ww, Ww, Ww, Ww, Ww, Ww, Ww, Ww, Ww, Ww, Ww, Ww, Ww, Ww, Gs, Ds, Hhd, Ds, Hh, Ds, Hhd, Ds, Gd, Ds, Gs, Gs, Gd, Mm, Mm, Mm, Mm, Mm^Xm, Mm^Xm, Mm, Mm^Xm, Mm^Xm, Mm, Mm^Xm, Mm^Xm, Mm, Mm, Mm, Mm, Mm, Mm, Mm, Mm, Mm, Mm, Mm, Mm^Xm, Mm, Mm, Mm, Mm^Xm, Mm
Gd, Ds, Ds, Ww, Ss^Vm, Ww, Ss, Ww, Ww, Ww, Ds, Ww, Ww, Ww, Ww, Ww, Ww, Ww, Ww, Ww, Ww, Ww, Ww, Ww, Ww, Ww, Ds, Ww, Ds, Gs, Gd, Ds, Gd, Hhd, Gd, Hh, Gs, Hhd, Hhd, Hhd, Hh, Gd, Hhd, Gd, Gd, Mm, Mm, Mm, Mm, Mm^Xm, Mm, Gll^Fet, Gll^Fp, Mm, Mm^Xm, Mm, Mm, Mm, Mm, Mm, Mm, Mm, Mm, Mm, Mm^Xm, Mm^Xm, Mm^Vhh, Mm^Xm, Mm^Xm, Mm^Xm, Mm^Xm, Mm
Ss, Ss, Gd, Ds, Gd, Ss, Ss, Ss, Ds, Ds, Ds, Ds, Ds, Ww, Gd, Ww, Ds, Ds, Hh, Ds, Gs, Ww, Ww, Ww, Ds, Ds, Gd, Ds, Gd, Gd, Gd, Gd, Hh, Gd, Hhd, Gd, Hh, Gs, Gs, Hh, Gd, Gd, Hh, Hh, Hhd, Hh, Mm, Mm, Mm, Mm, Mm, Mm, Gll^Ve, Mm, Mm, Mm^Xm, Mm^Xm, Mm, Mm^Xm, Mm, Mm^Xm, Mm, Mm^Xm, Mm^Xm, Mm, Mm, Mm, Mm, Mm, Mm^Xm, Mm, Mm
Ss, Ss, Chr, Chr, Chr, Ds, Ss, Ss, Ss, Ss, Ss, Ds, Re^Gvs, Re^Gvs, Gd, Gd, Hh, Hh, Hh, Hhd, Gd, Ds, Ds, Ds, Gd, Gd, Gd, Gs, Hh, Hhd, Hh, Gs, Gs, Gd, Gs, Gd, Hh, Hh, Hhd, Gd, Hhd, Hh, Gd, Hh^Vhh, Hhd, Hhd, Hh, Mm, Gll^Fp, Mm, Gll^Fp, Gll^Fp, Gll^Fp, Gll^Fp, Mm, Mm, Mm, Mm^Xm, Mm, Mm^Xm, Mm^Xm, Mm^Xm, Mm^Vhh, Mm, Mm, Mm, Mm, Mm, Mm, Mm, Mm, Mm
Ss, Ds, Chr, Khs, Chs, Gd, Ss, Gd, Ds, Ss^Vhs, Ss, Rd, Re^Gvs, Re^Gvs, Gd, Gd, Hhd, Hh, Hhd, Gd, Hhd, Hh^Vhh, Hhd, Gd, Gs, Hhd, Hhd, Hh, Gll, Hhd, Gd, Gd, Hhd, Hh, Hhd, Hhd, Gd, Hh, Hhd, Hhd, Hh, Gll^Fp, Gll^Fp, Gd, Hh, Hhd, Gll^Fp, Gll^Fp, Gll^Fp, Gll^Fp, Hhd, Gll^Fp, Gll^Fp, Gll^Fp, Mm, Mm, Mm, Mm, Mm, Mm^Xm, Mm, Mm, Mm, Mm, Mm, Mm, Mm, Mm, Mm, Mm, Mm, Gd
Ss, Gd, Gd, Chs, Ss, Gd, Ss, Ss, Ss, Ss, Ss, Ss, Gd, Hh, Hh, Gd, Hh, Hh, Gd, Hhd, Gd, Hhd, Hh, Hhd, Hh, Hh, Hh, Gll^Fp, Gll^Fp, Hhd, Hh, Hhd, Hhd, Hh, Hhd, Hhd, Gd, Hh, Re, Hh, Hhd, Hhd, Hh, Hhd, Re, Hh, Re, Gll^Fp, Gll^Fp, Hhd, Hhd, Hh, Hh, Hh, Hh, Hh, Hh, Hhd, Hh, Mm, Hh, Mm, Hhd, Mm, Hh, Hhd, Hh, Hh, Hhd, Mm, Hh, Gd
Gd, Ss, Ds, Gd, Ss, Ss, Ss, Ss, Gd, Rd, Gd, Gd, Hh, Hhd, Hh, Hh, Hhd, Gs, Gd, Gd, Gd, Gd, Hh, Gd, Hhd, Hh, Hh, Gll^Fp, Gll^Fp, Gll, Hhd, Hhd, Hhd, Gd, Hh, Gd, Hh, Re, Re, Hhd, Hh, Hh, Rd, Hhd, Gd, Re, Re, Re, Gll^Fp, Re, Gd, Hhd, Gd, Hh, Hh, Hh, Hhd, Hhd, Gd, Hhd, Hh, Hhd, Hh, Hh, Hh, Hh, Gs, Hh, Ce, Hhd, Hh, Gd
Gd, Ds, Rd, Ss, Ss, Ss^Vhs, Gll^Fp, Gll^Fp, Gs, Gll^Vc, Hhd, Hh, Gs, Gs, Hhd, Hh, Hhd, Hhd, Gll^Fp, Hhd, Hh, Hh, Hh, Hh, Hhd, Hh, Hhd, Hh, Gll^Fp, Gll^Vh, Hhd, Gd, Hh, Hh, Hhd, Hhd, Hhd, Re, Hh, Hhd, Rd, Rd, Gd, Hh, Gs, Gd, Gd, Gll^Fp, Gll^Fp, Re, Re, Gd, Re, Gd, Rd, Hh, Rd, Rd, Rd, Hhd, Re, Gd, Re, Gd, Rd, Gs, Rd, Ce, 1 Ke, Ce, Hhd, Gd
Ss, Ds, Ss, Ss, Ss, Gd, Gd, Gll^Fp, Gd, Gd, Hhd, Gd, Hhd, Hh, Hh, Hh, Gll^Fp, Gll^Fp, Gll^Fp, Hhd, Hhd, Hhd, Hhd, Hh, Gs, Hh, Hh, Gll, Gll, Hhd, Gd, Hh, Hh, Hhd, Gd, Gd, Hh, Hh, Hh, Hh, Rd, Rd, Gd, Gd, Gd, Gs, Gs, Gll^Fp, Gll^Fp, Gll^Fp, Gll^Fp, Re, Rd, Rd, Rd, Rd, Gd, Re, Rd, Hh, Hhd, Re, Rd, Rd, Gs, Rd, Rd, Ce, Ce, Ce, Hh, Gd
Gd, Ss, Rd, Ss, Gd, Gd, Gs, Gd, Gd, Gd, Gd, Hh, Gll^Fp, Gll^Fp, Gll^Fp, Hh, Gll^Fp, Hhd, Hhd, Hh, Hhd, Gd, Hhd, Hhd, Hh, Gd, Hh, Hhd, Hh, Hh, Hh, Hh, Hh, Hh, Re, Hh, Hhd, Gd, Hh, Hh, Hh, Hhd, Gd, Gs, Gd, Gll^Vh, Gd, Gll^Fp, Gll^Fp, Gll^Fp, Gll^Fp, Gd, Gs, Gd, Hhd, Gd, Hh, Gd, Hhd, Gll^Vh, Hh, Rd, Hh, Gd, Hh, Gd, Gs, Gd, Gd, Hh, Hhd, Gd
Gd, Gd, Gd, Gd, Rp, Rd, Rd, Rd, Rd, Rd, Rd, Rd, Rd, Gll^Fp, Hh, Hh, Gd, Rd, Rd, Rd, Rd, Rd, Rd, Hh, Hh, Hhd, Rd, Rd, Re, Hh, Hhd, Hhd, Rd, Hh, Hh, Hhd, Rd, Rd, Rd, Rd, Hh, Hh, Hh, Gd, Hhd, Gs, Gd, Gll^Fp, Gg^Ve, Gll^Fp, Gd, Gs, Hhd, Hh, Hhd, Hhd, Hh, Hh, Hh, Hh, Hhd, Hh, Hh, Hhd, Hh, Hh, Hhd, Hh, Hhd, Hhd, Mm, Gd
Rr, Rr, Rr, Rp, Gd, Rr, Gs, Gd, Gd, Gs, Gs, Gd, Re, Gll^Fp, Re, Re, Hh, Hh, Hhd, Hh, Hh, Hh, Gll^Fp, Hh, Re, Hhd, Hhd, Re, Hh, Hhd, Hh, Hh, Hhd, Rd, Hhd, Hhd, Hhd, Hhd, Hh, Hhd, Gd, Hh, Gd, Gs, Hh, Gd, Hhd, Gs, Hh, Hhd, Hh, Hhd, Hh, Hh, Mm, Hhd, Hh, Hh, Mm, Hhd, Hhd, Hhd, Hh, Hh, Mm, Hh, Mm, Hh, Mm, Mm^Vhh, Mm, Mm
Hh, Hh, Re, Gd, Gd, Gs, Gd, Gs, Re, Re, Re, Gd, Gd, Re, Hh, Hh, Gd, Hh, Hh, Gs, Hh, Hhd, Hh, Hh, Hhd, Re, Hh, Hh, Hhd, Gd, Hh, Gd, Gll, Gll^Fp, Hhd, Gll^Vh, Hhd, Hh, Hh, Hh, Hhd, Gd, Gd, Gs, Hh, Hh, Hhd, Hh, Hh, Hh, Mm, Mm, Mm, Mm, Mm, Mm, Mm, Mm, Mm, Mm, Mm, Mm, Mm, Mm, Mm, Mm, Mm, Mm, Mm, Mm, Mm, Mm
Gd, Hh, Gd, Re, Re, Gs, Gd, Re, Gd, Re, Gd, Gd, Hhd, Hhd, Gd, Gs, Gd, Hhd, Hh, Gd, Hh, Gd, Hhd, Hh, Hh, Re, Cer, Cer, Cer, Gd, Hhd, Hhd, Hhd, Gll^Fp, Hh, Gd, Hhd, Gd, Hh, Hhd, Gd, Gs, Gd, Gll^Fp, Gll^Fp, Gll^Fp, Hh, Hh, Hh, Hh, Mm, Mm, Mm, Mm, Mm, Mm, Mm, Mm, Mm, Mm, Mm^Xm, Mm, Mm^Xm, Mm, Mm, Mm, Mm, Mm, Mm, Mm, Mm, Mm
Gd, Gd, Gd, Gs, Gll^Vh, Re, Gs, Gs, Gd, Hh, Hh, Hhd, Hh, Gd, Gs, Gs, Gd, Gs, Gs, Gs, Hh, Hhd, Gd, Hhd, Hh, Hhd, Cer, Ker, Cer, Hh, Hh, Hhd, Hh, Hhd, Hh, Gd, Hh, Hhd, Hhd, Gd, Gs, Gd, Hh, Gll^Fp, Hhd, Hh, Hhd, Hh, Mm, Mm, Mm^Xm, Mm^Xm, Mm^Xm, Mm, Mm, Mm, Mm^Xm, Mm, Mm, Mm^Xm, Mm^Xm, Mm^Xm, Mm^Xm, Mm^Xm, Mm, Mm, Mm, Mm, Mm, Mm, Mm, Mm
Gd, Gs, Gd, Gd, Re^Gvs, Re^Gvs, Re^Gvs, Gd, Hhd, Hh, Gd, Hh, Hh, Gd, Hhd, Hhd, Gd, Gd, Hhd, Gg^Vh, Hhd, Gs, Gd, Hh, Hhd, Gd, Hhd, Cer, Gd, Hhd, Hh, Hhd, Hhd, Hhd, Hh, Hhd, Hh, Gd, Hh, Gs, Hh, Hh, Hhd, Hhd, Mm, Hh, Mm^Xm, Mm, Mm^Xm, Mm^Xm, Mm^Xm, Mm^Xm, Mm, Mm^Xm, Mm^Xm, Mm^Xm, Mm, Mm^Xm, Mm^Xm, Mm^Xm, Mm, Mm, Mm, Mm^Xm, Mm^Xm, Mm, Mm, Mm, Mm, Mm, Mm, Mm
Gs, Gd, Re^Gvs, Re^Gvs, Re^Gvs, Re^Gvs, Re^Gvs, Re^Gvs, Gs, Gd, Gd, Gd, Gd, Hh, Gd, Hh, Gd, Gd, Hhd, Hh, Hhd, Hhd, Hhd, Hh, Hh, Gd, Hhd, Gs, Hh, Hhd, Hhd, Gll^Fp, Gll^Fp, Hh, Hh, Gll^Fp, Gll^Fp, Hhd, Hhd, Gd, Hhd, Hh, Hhd, Mm, Mm, Mm, Mm^Xm, Mm^Xm, Mm^Xm, Mm, Mm, Mm, Mm, Mm, Mm, Mm, Mm, Mm, Mm, Mm, Mm, Mm, Mm, Mm, Mm, Mm^Xm, Mm^Xm, Mm^Xm, Mm^Xm, Mm, Mm, Mm
Gd, Re^Gvs, Re^Gvs, Re^Gvs, Re^Gvs, Re^Gvs, Gd, Gd, Gd, Gd, Hh, Hh, Hhd, Hhd, Hh, Hhd, Hhd, Gd, Gd, Hhd, Gs, Hhd, Gd, Gd, Hh, Hhd, Hh, Gs, Hh, Hh, Gd, Gd, Gll^Fp, Gll^Fp, Gll^Fp, Gll^Fp, Hh, Hhd, Hh, Hh, Hhd, Gd, Hh, Mm, Mm, Mm^Xm, Mm^Xm, Mm, Mm, Mm, Mm, Mm, Mm, Mm, Mm, Mm, Mm, Mm, Mm, Mm, Mm, Mm, Mm^Xm, Mm, Mm, Mm, Mm, Mm, Mm, Mm^Xm, Mm^Xm, Mm
Gs, Gd, Gd, Re^Gvs, Gs, Gd, Gd, Gs, Gd, Gd, Gd, Hhd, Gd, Gd, Gs, Gs, Gs, Gd, Gs, Gd, Gs, Gd, Gs, Gd, Gd, Gd, Gd, Gs, Gs, Gd, Gs, Gs, Gs, Gs, Gd, Gd, Gs, Gd, Gd, Gd, Gd, Hhd, Hh, Mm, Gg, Mm^Xm, Mm^Xm, Mm, Mm, Mm, Mm, Mm, Mm, Mm, Gg, Mm, Gg, Mm, Gg, Mm, Gg, Mm, Mm, Mm, Mm, Mm, Mm, Mm, Mm, Mm, Mm, Mm^Xm
