Wog, Wog, Wog, Wog, Wog, Wog, Wog, Ww, Wog, Wwg, Wwg, Wwg, Wwg, Wwg, Wwg, Wwg, Wwg, Wwg, Wwg, Wwg, Wwg, Wwg, Wwg, Wwg, Wwg, Wwg, Wwg, Wwg, Wog, Wog, Wog, Wog, Wog, Wog, Wog, Wog, Wog, Wog, Wog, Wog, Wog, Wog, Wwg, Wwg, Md, Ww, Ds, Gg, Md, Md, Md, Md, Md, Md, Md, Md, Md, Md, Md, Md, Md, Md, Md, Md, Md, Md, Md, Md, Md, Md, Md, Ww
Wwg, Wog, Wwg, Wog, Wog, Wog, Wog, Wog, Wog, Wog, Wog, Wog, Wog, Wog, Wog, Wwg, Wog, Wog, Wog, Wwg, Wog, Wwg, Wog, Wwg, Wog, Wog, Wog, Wog, Wog, Wog, Wwg, Wog, Wog, Wog, Wwg, Wwg, Wwg, Wog, Wwg, Wog, Wwg, Wwg, Md, Md^Xm, Md^Xm, Md, Md, Md, Md, Md, Md, Md, Md, Md, Md, Md, Md, Md, Md, Md, Md, Md, Md, Md, Md, Md, Md, Md, Md, Md, Md, Md
Wwg, Wwg, Wwg, Wwg, Wwg, Wwg, Wwg, Wwg, Wwg, Wog, Wwg, Wog, Wwg, Wog, Wog, Wog, Wog, Wog, Wog, Wog, Wog, Wog, Wog, Wog, Wog, Wog, Wwg, Wog, Wwg, Wwg, Wwg, Wwg, Wwg, Wwg, Wwg, Wwg, Ds, Wwg, Ds, Wwg, Ds, Ds, Md, Md, Md, Md^Xm, Md^Xm, Md, Md, Md, Md, Md, Md^Xm, Md, Md, Md, Md, Md, Md, Md, Md, Md, Md, Md, Md, Md, Md, Md, Md, Md, Md, Md
Wwg, Wwg, Wwg, Wwg, Wwg, Wwg, Wwg, Wwg, Wwg, Wwg, Wwg, Wwg, Wwg, Wwg, Wwg, Wwg, Wwg, Wog, Wwg, Wwg, Wwg, Wog, Wwg, Wwg, Wwg, Wwg, Wwg, Wwg, Wwg, Wwg, Gs, Ds, Hhd, Ds, Hh, Ds, Hhd, Ds, Gd, Ds, Gs, Gs, Gd, Md, Md, Md, Md, Md^Xm, Md^Xm, Md, Md^Xm, Md^Xm, Md, Md^Xm, Md^Xm, Md, Md, Md, Md, Md, Md, Md, Md, Md, Md, Md, Md^Xm, Md, Md, Md, Md^Xm, Md^Xm
Gd, Ds, Ds, Wwg, Ss^Vm, Wwg, Ss, Wwg, Wwg, Wwg, Ds, Wwg, Wwg, Wwg, Wwg, Wwg, Wwg, Wwg, Wwg, Wwg, Wwg, Wwg, Wwg, Wwg, Wwg, Wwg, Ds, Wwg, Ds, Gs, Gd, Ds, Gd, Hhd, Gd, Hh, Gs, Hhd, Hhd, Hhd, Hh, Gd, Hhd, Gd, Gd, Md, Md, Md, Md, Md^Xm, Md, Gll^Fet, Gll^Fp, Md, Md^Xm, Md, Md, Md, Md, Md, Md, Md, Md, Md, Md^Xm, Md^Xm, Md^Vhh, Md^Xm, Md^Xm, Md^Xm, Md^Xm, Md^Xm
Ss, Ss, Gd, Ds, Gd, Ss, Ss, Ss, Ds, Ds, Ds, Ds, Ds, Wwg, Gd, Wwg, Ds, Ds, Hh, Ds, Gs, Wwg, Wwg, Wwg, Ds, Ds, Gd, Ds, Gd, Gd, Gd, Gd, Hh, Gd, Hhd, Gd, Hh, Gs, Gs, Hh, Gd, Gd, Hh, Hh, Hhd, Hh, Md, Md, Md, Md, Md, Md, Gll^Ve, Md, Md, Md^Xm, Md^Xm, Md, Md^Xm, Md, Md^Xm, Md, Md^Xm, Md^Xm, Md, Md, Md, Md, Md, Md^Xm, Md, Md
Ss, Ss, Chr, Chr, Chr, Ds, Ss, Ss, Ss, Ss, Ss, Ds, Re^Gvs, Re^Gvs, Gd, Gd, Hh, Hh, Hh, Hhd, Gd, Ds, Ds, Ds, Gd, Gd, Gd, Gs, Hh, Hhd, Hh, Gs, Gs, Gd, Gs, Gd, Hh, Hh, Hhd, Gd, Hhd, Hh, Gd, Hh^Vhh, Hhd, Hhd, Hh, Md, Gll^Fp, Md, Gll^Fp, Gll^Fp, Gll^Fp, Gll^Fp, Md, Md, Md, Md^Xm, Md, Md^Xm, Md^Xm, Md^Xm, Md^Vhh, Md, Md, Md, Md, Md, Md, Md, Md, Md
Ss, Ds, Chr, Khs, Chs, Gd, Ss, Gd, Ds, Ss^Vhs, Ss, Rd, Re^Gvs, Re^Gvs, Gd, Gd, Hhd, Hh, Hhd, Gd, Hhd, Hh^Vhh, Hhd, Gd, Gs, Hhd, Hhd, Hh, Gll, Hhd, Gd, Gd, Hhd, Hh, Hhd, Hhd, Gd, Hh, Hhd, Hhd, Hh, Gll^Fp, Gll^Fp, Gd, Hh, Hhd, Gll^Fp, Gll^Fp, Gll^Fp, Gll^Fp, Hhd, Gll^Fp, Gll^Fp, Gll^Fp, Md, Md, Md, Md, Md, Md^Xm, Md, Md, Md, Md, Md, Md, Md, Md, Md, Md, Md, Hhd
Ss, Gd, Gd, Chs, Ss, Gd, Ss, Ss, Ss, Ss, Ss, Ss, Gd, Hh, Hh, Gd, Hh, Hh, Gd, Hhd, Gd, Hhd, Hh, Hhd, Hh, Hh, Hh, Gll^Fp, Gll^Fp, Hhd, Hh, Hhd, Hhd, Hh, Hhd, Hhd, Gd, Hh, Re, Hh, Hhd, Hhd, Hh, Hhd, Re, Hh, Re, Gll^Fp, Gll^Fp, Hhd, Hhd, Hh, Hh, Hh, Hh, Hh, Hh, Hhd, Hh, Md, Hh, Md, Hhd, Md, Hh, Hhd, Hh, Hh, Hhd, Md, Hh, Hhd
Gd, Ss, Ds, Gd, Ss, Ss, Ss, Ss, Gd, Rd, Gd, Gd, Hh, Hhd, Hh, Hh, Hhd, Gs, Gd, Gd, Gd, Gd, Hh, Gd, Hhd, Hh, Hh, Gll^Fp, Gll^Fp, Gll, Hhd, Hhd, Hhd, Gd, Hh, Gd, Hh, Re, Re, Hhd, Hh, Hh, Rd, Hhd, Gd, Re, Re, Re, Gll^Fp, Re, Gd, Hhd, Gd, Hh, Hh, Hh, Hhd, Hhd, Gd, Hhd, Hh, Hhd, Hh, Hh, Hh, Hh, Gs, Hh, Ce, Hhd, Hh, Hhd
Gd, Ds, Rd, Ss, Ss, Ss^Vhs, Gll^Fp, Gll^Fp, Gs, Gll^Vc, Hhd, Hh, Gs, Gs, Hhd, Hh, Hhd, Hhd, Gll^Fp, Hhd, Hh, Hh, Hh, Hh, Hhd, Hh, Hhd, Hh, Gll^Fp, Gll^Vh, Hhd, Gd, Hh, Hh, Hhd, Hhd, Hhd, Re, Hh, Hhd, Rd, Rd, Gd, Hh, Gs, Gd, Gd, Gll^Fp, Gll^Fp, Re, Re, Gd, Re, Gd, Rd, Hh, Rd, Rd, Rd, Hhd, Re, Gd, Re, Gd, Rd, Gs, Rd, Ce, 1 Ke, Ce, Hhd, Hhd
Ss, Ds, Ss, Ss, Ss, Gd, Gd, Gll^Fp, Gd, Gd, Hhd, Gd, Hhd, Hh, Hh, Hh, Gll^Fp, Gll^Fp, Gll^Fp, Hhd, Hhd, Hhd, Hhd, Hh, Gs, Hh, Hh, Gll, Gll, Hhd, Gd, Hh, Hh, Hhd, Gd, Gd, Hh, Hh, Hh, Hh, Rd, Rd, Gd, Gd, Gd, Gs, Gs, Gll^Fp, Gll^Fp, Gll^Fp, Gll^Fp, Re, Rd, Rd, Rd, Rd, Gd, Re, Rd, Hh, Hhd, Re, Rd, Rd, Gs, Rd, Rd, Ce, Ce, Ce, Hh, Hhd
Gd, Ss, Rd, Ss, Gd, Gd, Gs, Gd, Gd, Gd, Gd, Hh, Gll^Fp, Gll^Fp, Gll^Fp, Hh, Gll^Fp, Hhd, Hhd, Hh, Hhd, Gd, Hhd, Hhd, Hh, Gd, Hh, Hhd, Hh, Hh, Hh, Hh, Hh, Hh, Re, Hh, Hhd, Gd, Hh, Hh, Hh, Hhd, Gd, Gs, Gd, Gll^Vh, Gd, Gll^Fp, Gll^Fp, Gll^Fp, Gll^Fp, Gd, Gs, Gd, Hhd, Gd, Hh, Gd, Hhd, Gll^Vh, Hh, Rd, Hh, Gd, Hh, Gd, Gs, Gd, Gd, Hh, Hhd, Hhd
Gd, Gd, Gd, Gd, Rp, Rd, Rd, Rd, Rd, Rd, Rd, Rd, Rd, Gll^Fp, Hh, Hh, Gd, Rd, Rd, Rd, Rd, Rd, Rd, Hh, Hh, Hhd, Rd, Rd, Re, Hh, Hhd, Hhd, Rd, Hh, Hh, Hhd, Rd, Rd, Rd, Rd, Hh, Hh, Hh, Gd, Hhd, Gs, Gd, Gll^Fp, Gg^Ve, Gll^Fp, Gd, Gs, Hhd, Hh, Hhd, Hhd, Hh, Hh, Hh, Hh, Hhd, Hh, Hh, Hhd, Hh, Hh, Hhd, Hh, Hhd, Hhd, Md, Hhd
Rr, Rr, Rr, Rp, Gd, Rr, Gs, Gd, Gd, Gs, Gs, Gd, Re, Gll^Fp, Re, Re, Hh, Hh, Hhd, Hh, Hh, Hh, Gll^Fp, Hh, Re, Hhd, Hhd, Re, Hh, Hhd, Hh, Hh, Hhd, Rd, Hhd, Hhd, Hhd, Hhd, Hh, Hhd, Gd, Hh, Gd, Gs, Hh, Gd, Hhd, Gs, Hh, Hhd, Hh, Hhd, Hh, Hh, Md, Hhd, Hh, Hh, Md, Hhd, Hhd, Hhd, Hh, Hh, Md, Hh, Md, Hh, Md, Md^Vhh, Md, Md
Hh, Hh, Re, Gd, Gd, Gs, Gd, Gs, Re, Re, Re, Gd, Gd, Re, Hh, Hh, Gd, Hh, Hh, Gs, Hh, Hhd, Hh, Hh, Hhd, Re, Hh, Hh, Hhd, Gd, Hh, Gd, Gll, Gll^Fp, Hhd, Gll^Vh, Hhd, Hh, Hh, Hh, Hhd, Gd, Gd, Gs, Hh, Hh, Hhd, Hh, Hh, Hh, Md, Md, Md, Md, Md, Md, Md, Md, Md, Md, Md, Md, Md, Md, Md, Md, Md, Md, Md, Md, Md^Xm, Md
Gd, Hh, Gd, Re, Re, Gs, Gd, Re, Gd, Re, Gd, Gd, Hhd, Hhd, Gd, Gs, Gd, Hhd, Hh, Gd, Hh, Gd, Hhd, Hh, Hh, Re, Cer, Cer, Cer, Gd, Hhd, Hhd, Hhd, Gll^Fp, Hh, Gd, Hhd, Gd, Hh, Hhd, Gd, Gs, Gd, Gll^Fp, Gll^Fp, Gll^Fp, Hh, Hh, Hh, Hh, Md, Md, Md, Md, Md, Md, Md, Md, Md, Md, Md^Xm, Md, Md^Xm, Md, Md, Md, Md, Md, Md^Xm, Md^Xm, Md, Md^Xm
Gd, Gd, Gd, Gs, Gll^Vh, Re, Gs, Gs, Gd, Hh, Hh, Hhd, Hh, Gd, Gs, Gs, Gd, Gs, Gs, Gs, Hh, Hhd, Gd, Hhd, Hh, Hhd, Cer, Ker, Cer, Hh, Hh, Hhd, Hh, Hhd, Hh, Gd, Hh, Hhd, Hhd, Gd, Gs, Gd, Hh, Gll^Fp, Hhd, Hh, Hhd, Hh, Md, Md, Md^Xm, Md^Xm, Md^Xm, Md, Md, Md, Md^Xm, Md, Md, Md^Xm, Md^Xm, Md^Xm, Md^Xm, Md^Xm, Md, Md, Md, Md, Md^Xm, Md, Md, Md
Gd, Gs, Gd, Gd, Re^Gvs, Re^Gvs, Re^Gvs, Gd, Hhd, Hh, Gd, Hh, Hh, Gd, Hhd, Hhd, Gd, Gd, Hhd, Gg^Vh, Hhd, Gs, Gd, Hh, Hhd, Gd, Hhd, Cer, Gd, Hhd, Hh, Hhd, Hhd, Hhd, Hh, Hhd, Hh, Gd, Hh, Gs, Hh, Hh, Hhd, Hhd, Md, Hh, Md^Xm, Md, Md^Xm, Md^Xm, Md^Xm, Md^Xm, Md, Md^Xm, Md^Xm, Md^Xm, Md, Md^Xm, Md^Xm, Md^Xm, Md, Md, Md, Md^Xm, Md^Xm, Md, Md^Xm, Md^Xm, Md, Md, Md, Md
Gs, Gd, Re^Gvs, Re^Gvs, Re^Gvs, Re^Gvs, Re^Gvs, Re^Gvs, Gs, Gd, Gd, Gd, Gd, Hh, Gd, Hh, Gd, Gd, Hhd, Hh, Hhd, Hhd, Hhd, Hh, Hh, Gd, Hhd, Gs, Hh, Hhd, Hhd, Gll^Fp, Gll^Fp, Hh, Hh, Gll^Fp, Gll^Fp, Hhd, Hhd, Gd, Hhd, Hh, Hhd, Md, Md, Md, Md^Xm, Md^Xm, Md^Xm, Md, Md, Md, Md, Md, Md, Md, Md, Md, Md, Md, Md, Md, Md, Md, Md, Md^Xm, Md^Xm, Md^Xm, Md^Xm, Md, Md, Md
Gd, Re^Gvs, Re^Gvs, Re^Gvs, Re^Gvs, Re^Gvs, Gd, Gd, Gd, Gd, Hh, Hh, Hhd, Hhd, Hh, Hhd, Hhd, Gd, Gd, Hhd, Gs, Hhd, Gd, Gd, Hh, Hhd, Hh, Gs, Hh, Hh, Gd, Gd, Gll^Fp, Gll^Fp, Gll^Fp, Gll^Fp, Hh, Hhd, Hh, Hh, Hhd, Gd, Hh, Md, Md, Md^Xm, Md^Xm, Md, Md, Md, Md, Md, Md, Md, Md, Md, Md, Md, Md, Md, Md, Md, Mm^Xm, Md, Md, Md, Md, Md, Md, Md^Xm, Md^Xm, Md
Gs, Gd, Gd, Re^Gvs, Gs, Gd, Gd, Gs, Gd, Gd, Gd, Hhd, Gd, Gd, Gs, Gs, Gs, Gd, Gs, Gd, Gs, Gd, Gs, Gd, Gd, Gd, Gd, Gs, Gs, Gd, Gs, Gs, Gs, Gs, Gd, Gd, Gs, Gd, Gd, Gd, Gd, Hhd, Hh, Md, Gg, Md^Xm, Md^Xm, Md, Md, Md, Md, Md, Md, Md, Gg, Md, Gg, Md, Gg, Md, Gg, Md, Md, Md, Md, Md, Md, Md, Md, Md, Md, Md^Xm
