Wog, Wog, Wog, Wog, Wog, Wog, Wog, Ww, Wog, Wwg, Wwg, Wwg, Wwg, Wwg, Wwg, Wwg, Wwg, Wwg, Wwg, Wwg, Wwg, Wwg, Wwg, Wwg, Wwg, Wwg, Wwg, Wwg, Wog, Wog, Wog, Wog, Wog, Wog, Wog, Wog, Wog, Wog, Wog, Wog, Wog, Wog, Wwg, Wwg, Md, Ww, Ds, Gg, Md, Md, Md, Md, Md, Md, Md, Md, Md, Md, Md, Md, Md, Md, Md, Md, Md, Md, Md, Md, Md, Md, Md, Ww
Wwg, Wog, Wwg, Wog, Wog, Wog, Wog, Wog, Wog, Wog, Wog, Wog, Wog, Wog, Wog, Wwg, Wog, Wog, Wog, Wwg, Wog, Wwg, Wog, Wwg, Wog, Wog, Wog, Wog, Wog, Wog, Wwg, Wog, Wog, Wog, Wwg, Wwg, Wwg, Wog, Wwg, Wog, Wwg, Wwg, Md, Md^Xm, Md^Xm, Md, Md, Md, Md, Md, Md, Md, Md, Md, Md, Md, Md, Md, Md, Md, Md, Md, Md, Md, Md, Md, Md, Md, Md, Md, Md, Md
Wwg, Wwg, Wwg, Wwg, Wwg, Wwg, Wwg, Wwg, Wwg, Wog, Wwg, Wog, Wwg, Wog, Wog, Wog, Wog, Wog, Wog, Wog, Wog, Wog, Wog, Wog, Wog, Wog, Wwg, Wog, Wwg, Wwg, Wwg, Wwg, Wwg, Wwg, Wwg, Wwg, Ds, Wwg, Ds, Wwg, Ds, Ds, Md, Md, Md, Md^Xm, Md^Xm, Md, Md, Md, Md, Md, Md^Xm, Md, Md, Md, Md, Md, Md, Md, Md, Md, Md, Md, Md, Md, Md, Md, Md, Md, Md, Md
Wwg, Wwg, Wwg, Wwg, Wwg, Wwg, Wwg, Wwg, Wwg, Wwg, Wwg, Wwg, Wwg, Wwg, Wwg, Wwg, Wwg, Wog, Wwg, Wwg, Wwg, Wog, Wwg, Wwg, Wwg, Wwg, Wwg, Wwg, Wwg, Wwg, Gs, Ds, Hhd, Ds, Hhd, Ds, Hhd, Ds, Gd, Ds, Gs, Gs, Gd, Md, Md, Md, Md, Md^Xm, Md^Xm, Md, Md^Xm, Md^Xm, Md, Md^Xm, Md^Xm, Md, Md, Md, Md, Md, Md, Md, Md, Md, Md, Md, Md^Xm, Md, Md, Md, Md^Xm, Md^Xm
Gd, Ds, Ds, Wwg, Ss^Vm, Wwg, Ss, Wwg, Wwg, Wwg, Ds, Wwg, Wwg, Wwg, Wwg, Wwg, Wwg, Wwg, Wwg, Wwg, Wwg, Wwg, Wwg, Wwg, Wwg, Wwg, Ds, Wwg, Ds, Gs, Gd, Ds, Gd, Hhd, Gd, Hhd, Gs, Hhd, Hhd, Hhd, Hhd, Gd, Hhd, Gd, Gd, Md, Md, Md, Md, Md^Xm, Md, Gll^Fet, Gll^Fp, Md, Md^Xm, Md, Md, Md, Md, Md, Md, Md, Md, Md, Md^Xm, Md^Xm, Md^Vhh, Md^Xm, Md^Xm, Md^Xm, Md^Xm, Md^Xm
Ss, Ss, Gd, Ds, Gd, Ss, Ss, Ss, Ds, Ds, Ds, Ds, Ds, Wwg, Gd, Wwg, Ds, Ds, Hhd, Ds, Gs, Wwg, Wwg, Wwg, Ds, Ds, Gd, Ds, Gd, Gd, Gd, Gd, Hhd, Gd, Hhd, Gd, Hhd, Gs, Gs, Hhd, Gd, Gd, Hhd, Hhd, Hhd, Hhd, Md, Md, Md, Md, Md, Md, Gll^Ve, Md, Md, Md^Xm, Md^Xm, Md, Md^Xm, Md, Md^Xm, Md, Md^Xm, Md^Xm, Md, Md, Md, Md, Md, Md^Xm, Md, Md
Ss, Ss, Chr, Chr, Chr, Ds, Ss, Ss, Ss, Ss, Ss, Ds, Re^Gvs, Re^Gvs, Gd, Gd, Hhd, Hhd, Hhd, Hhd, Gd, Ds, Ds, Ds, Gd, Gd, Gd, Gs, Hhd, Hhd, Hhd, Gs, Gs, Gd, Gs, Gd, Hhd, Hhd, Hhd, Gd, Hhd, Hhd, Gd, Hhd^Vhh, Hhd, Hhd, Hhd, Md, Gll^Fp, Md, Gll^Fp, Gll^Fp, Gll^Fp, Gll^Fp, Md, Md, Md, Md^Xm, Md, Md^Xm, Md^Xm, Md^Xm, Md^Vhh, Md, Md, Md, Md, Md, Md, Md, Md, Md
Ss, Ds, Chr, Khs, Chs, Gd, Ss, Gd, Ds, Ss^Vhs, Ss, Rd, Re^Gvs, Re^Gvs, Gd, Gd, Hhd, Hhd, Hhd, Gd, Hhd, Hh^Vhh, Hhd, Gd, Gs, Hhd, Hhd, Hhd, Gll, Hhd, Gd, Gd, Hhd, Hhd, Hhd, Hhd, Gd, Hhd, Hhd, Hhd, Hhd, Gll^Fp, Gll^Fp, Gd, Hhd, Hhd, Gll^Fp, Gll^Fp, Gll^Fp, Gll^Fp, Hhd, Gll^Fp, Gll^Fp, Gll^Fp, Md, Md, Md, Md, Md, Md^Xm, Md, Md, Md, Md, Md, Md, Md, Md, Md, Md, Md, Hhd
Ss, Gd, Gd, Chs, Ss, Gd, Ss, Ss, Ss, Ss, Ss, Ss, Gd, Hhd, Hhd, Gd, Hhd, Hhd, Gd, Hhd, Gd, Hhd, Hhd, Hhd, Hhd, Hhd, Hhd, Gll^Fp, Gll^Fp, Hhd, Hhd, Hhd, Hhd, Hhd, Hhd, Hhd, Gd, Hhd, Re, Hhd, Hhd, Hhd, Hhd, Hhd, Re, Hhd, Re, Gll^Fp, Gll^Fp, Hhd, Hhd, Hhd, Hhd, Hhd, Hhd, Hhd, Hhd, Hhd, Hhd, Md, Hhd, Md, Hhd, Md, Hhd, Hhd, Hhd, Hhd, Hhd, Md, Hhd, Hhd
Gd, Ss, Ds, Gd, Ss, Ss, Ss, Ss, Gd, Rd, Gd, Gd, Hhd, Hhd, Hhd, Hhd, Hhd, Gs, Gd, Gd, Gd, Gd, Hhd, Gd, Hhd, Hhd, Hhd, Gll^Fp, Gll^Fp, Gll, Hhd, Hhd, Hhd, Gd, Hhd, Gd, Hhd, Re, Re, Hhd, Hhd, Hhd, Rd, Hhd, Gd, Re, Re, Re, Gll^Fp, Re, Gd, Hhd, Gd, Hhd, Hhd, Hhd, Hhd, Hhd, Gd, Hhd, Hhd, Hhd, Hhd, Hhd, Hhd, Hhd, Gs, Hhd, Ce, Hhd, Hhd, Hhd
Gd, Ds, Rd, Ss, Ss, Ss^Vhs, Gll^Fp, Gll^Fp, Gs, Gll^Vc, Hhd, Hhd, Gs, Gs, Hhd, Hhd, Hhd, Hhd, Gll^Fp, Hhd, Hhd, Hhd, Hhd, Hhd, Hhd, Hhd, Hhd, Hhd, Gll^Fp, Gll^Vh, Hhd, Gd, Hhd, Hhd, Hhd, Hhd, Hhd, Re, Hhd, Hhd, Rd, Rd, Gd, Hhd, Gs, Gd, Gd, Gll^Fp, Gll^Fp, Re, Re, Gd, Re, Gd, Rd, Hhd, Rd, Rd, Rd, Hhd, Re, Gd, Re, Gd, Rd, Gs, Rd, Ce, 1 Ke, Ce, Hhd, Hhd
Ss, Ds, Ss, Ss, Ss, Gd, Gd, Gll^Fp, Gd, Gd, Hhd, Gd, Hhd, Hhd, Hhd, Hhd, Gll^Fp, Gll^Fp, Gll^Fp, Hhd, Hhd, Hhd, Hhd, Hhd, Gs, Hhd, Hhd, Gll, Gll, Hhd, Gd, Hhd, Hhd, Hhd, Gd, Gd, Hhd, Hhd, Hhd, Hhd, Rd, Rd, Gd, Gd, Gd, Gs, Gs, Gll^Fp, Gll^Fp, Gll^Fp, Gll^Fp, Re, Rd, Rd, Rd, Rd, Gd, Re, Rd, Hhd, Hhd, Re, Rd, Rd, Gs, Rd, Rd, Ce, Ce, Ce, Hhd, Hhd
Gd, Ss, Rd, Ss, Gd, Gd, Gs, Gd, Gd, Gd, Gd, Hhd, Gll^Fp, Gll^Fp, Gll^Fp, Hhd, Gll^Fp, Hhd, Hhd, Hhd, Hhd, Gd, Hhd, Hhd, Hhd, Gd, Hhd, Hhd, Hhd, Hhd, Hhd, Hhd, Hhd, Hhd, Re, Hhd, Hhd, Gd, Hhd, Hhd, Hhd, Hhd, Gd, Gs, Gd, Gll^Vh, Gd, Gll^Fp, Gll^Fp, Gll^Fp, Gll^Fp, Gd, Gs, Gd, Hhd, Gd, Hhd, Gd, Hhd, Gll^Vh, Hhd, Rd, Hhd, Gd, Hhd, Gd, Gs, Gd, Gd, Hhd, Hhd, Hhd
Gd, Gd, Gd, Gd, Rp, Rd, Rd, Rd, Rd, Rd, Rd, Rd, Rd, Gll^Fp, Hhd, Hhd, Gd, Rd, Rd, Rd, Rd, Rd, Rd, Hhd, Hhd, Hhd, Rd, Rd, Re, Hhd, Hhd, Hhd, Rd, Hhd, Hhd, Hhd, Rd, Rd, Rd, Rd, Hhd, Hhd, Hhd, Gd, Hhd, Gs, Gd, Gll^Fp, Gg^Ve, Gll^Fp, Gd, Gs, Hhd, Hhd, Hhd, Hhd, Hhd, Hhd, Hhd, Hhd, Hhd, Hhd, Hhd, Hhd, Hhd, Hhd, Hhd, Hhd, Hhd, Hhd, Md, Hhd
Rr, Rr, Rr, Rp, Gd, Rr, Gs, Gd, Gd, Gs, Gs, Gd, Re, Gll^Fp, Re, Re, Hhd, Hhd, Hhd, Hhd, Hhd, Hhd, Gll^Fp, Hhd, Re, Hhd, Hhd, Re, Hhd, Hhd, Hhd, Hhd, Hhd, Rd, Hhd, Hhd, Hhd, Hhd, Hhd, Hhd, Gd, Hhd, Gd, Gs, Hhd, Gd, Hhd, Gs, Hhd, Hhd, Hhd, Hhd, Hhd, Hhd, Md, Hhd, Hhd, Hhd, Md, Hhd, Hhd, Hhd, Hhd, Hhd, Md, Hhd, Md, Hhd, Md, Md^Vhh, Md, Md
Hh, Hh, Re, Gd, Gd, Gs, Gd, Gs, Re, Re, Re, Gd, Gd, Re, Hhd, Hhd, Gd, Hhd, Hhd, Gs, Hhd, Hhd, Hhd, Hhd, Hhd, Re, Hhd, Hhd, Hhd, Gd, Hhd, Gd, Gll, Gll^Fp, Hhd, Gll^Vh, Hhd, Hhd, Hhd, Hhd, Hhd, Gd, Gd, Gs, Hhd, Hhd, Hhd, Hhd, Hhd, Hhd, Md, Md, Md, Md, Md, Md, Md, Md, Md, Md, Md, Md, Md, Md, Md, Md, Md, Md, Md, Md, Md^Xm, Md
Gd, Hh, Gd, Re, Re, Gs, Gd, Re, Gd, Re, Gd, Gd, Hhd, Hhd, Gd, Gs, Gd, Hhd, Hhd, Gd, Hhd, Gd, Hhd, Hhd, Hhd, Re, Cer, Cer, Cer, Gd, Hhd, Hhd, Hhd, Gll^Fp, Hhd, Gd, Hhd, Gd, Hhd, Hhd, Gd, Gs, Gd, Gll^Fp, Gll^Fp, Gll^Fp, Hhd, Hhd, Hhd, Hhd, Md, Md, Md, Md, Md, Md, Md, Md, Md, Md, Md^Xm, Md, Md^Xm, Md, Md, Md, Md, Md, Md^Xm, Md^Xm, Md, Md^Xm
Gd, Gd, Gd, Gs, Gll^Vh, Re, Gs, Gs, Gd, Hhd, Hhd, Hhd, Hhd, Gd, Gs, Gs, Gd, Gs, Gs, Gs, Hhd, Hhd, Gd, Hhd, Hhd, Hhd, Cer, Ker, Cer, Hhd, Hhd, Hhd, Hhd, Hhd, Hhd, Gd, Hhd, Hhd, Hhd, Gd, Gs, Gd, Hhd, Gll^Fp, Hhd, Hhd, Hhd, Hhd, Md, Md, Md^Xm, Md^Xm, Md^Xm, Md, Md, Md, Md^Xm, Md, Md, Md^Xm, Md^Xm, Md^Xm, Md^Xm, Md^Xm, Md, Md, Md, Md, Md^Xm, Md, Md, Md
Gd, Gs, Gd, Gd, Re^Gvs, Re^Gvs, Re^Gvs, Gd, Hhd, Hhd, Gd, Hhd, Hhd, Gd, Hhd, Hhd, Gd, Gd, Hhd, Gg^Vh, Hhd, Gs, Gd, Hhd, Hhd, Gd, Hhd, Cer, Gd, Hhd, Hhd, Hhd, Hhd, Hhd, Hhd, Hhd, Hhd, Gd, Hhd, Gs, Hhd, Hhd, Hhd, Hhd, Md, Hhd, Md^Xm, Md, Md^Xm, Md^Xm, Md^Xm, Md^Xm, Md, Md^Xm, Md^Xm, Md^Xm, Md, Md^Xm, Md^Xm, Md^Xm, Md, Md, Md, Md^Xm, Md^Xm, Md, Md^Xm, Md^Xm, Md, Md, Md, Md
Gs, Gd, Re^Gvs, Re^Gvs, Re^Gvs, Re^Gvs, Re^Gvs, Re^Gvs, Gs, Gd, Gd, Gd, Gd, Hhd, Gd, Hhd, Gd, Gd, Hhd, Hhd, Hhd, Hhd, Hhd, Hhd, Hhd, Gd, Hhd, Gs, Hhd, Hhd, Hhd, Gll^Fp, Gll^Fp, Hhd, Hhd, Gll^Fp, Gll^Fp, Hhd, Hhd, Gd, Hhd, Hhd, Hhd, Md, Md, Md, Md^Xm, Md^Xm, Md^Xm, Md, Md, Md, Md, Md, Md, Md, Md, Md, Md, Md, Md, Md, Md, Md, Md, Md^Xm, Md^Xm, Md^Xm, Md^Xm, Md, Md, Md
Gd, Re^Gvs, Re^Gvs, Re^Gvs, Re^Gvs, Re^Gvs, Gd, Gd, Gd, Gd, Hhd, Hhd, Hhd, Hhd, Hhd, Hhd, Hhd, Gd, Gd, Hhd, Gs, Hhd, Gd, Gd, Hhd, Hhd, Hhd, Gs, Hhd, Hhd, Gd, Gd, Gll^Fp, Gll^Fp, Gll^Fp, Gll^Fp, Hhd, Hhd, Hhd, Hhd, Hhd, Gd, Hhd, Md, Md, Md^Xm, Md^Xm, Md, Md, Md, Md, Md, Md, Md, Md, Md, Md, Md, Md, Md, Md, Md, Mm^Xm, Md, Md, Md, Md, Md, Md, Md^Xm, Md^Xm, Md
Gs, Gd, Gd, Re^Gvs, Gs, Gd, Gd, Gs, Gd, Gd, Gd, Hhd, Gd, Gd, Gs, Gs, Gs, Gd, Gs, Gd, Gs, Gd, Gs, Gd, Gd, Gd, Gd, Gs, Gs, Gd, Gs, Gs, Gs, Gs, Gd, Gd, Gs, Gd, Gd, Gd, Gd, Hhd, Hhd, Md, Gg, Md^Xm, Md^Xm, Md, Md, Md, Md, Md, Md, Md, Gg, Md, Gg, Md, Gg, Md, Gg, Md, Md, Md, Md, Md, Md, Md, Md, Md, Md, Md^Xm
