Wog, Wog, Wog, Wog, Wog, Wog, Wog, Ww, Wog, Wwg, Wwg, Wwg, Wwg, Wwg, Wwg, Wwg, Wwg, Wwg, Wwg, Wwg, Wwg, Wwg, Wwg, Wwg, Wwg, Wwg, Wwg, Wwg, Wog, Wog, Wog, Wog, Wog, Wog, Wog, Wog, Wog, Wog, Wog, Wog, Wog, Wog, Wwg, Wwg, Md, Md, Md, Md, Md, Md, Md, Md, Md, Md, Md, Md, Md, Md, Md, Md, Md, Md, Md, Md, Md, Md, Md, Md, Md, Md, Md, Ww
Wwg, Wog, Wwg, Wog, Wog, Wog, Wog, Wog, Wog, Wog, Wog, Wog, Wog, Wog, Wog, Wwg, Wog, Wog, Wog, Wwg, Wog, Wwg, Wog, Wwg, Wog, Wog, Wog, Wog, Wog, Wog, Wwg, Wog, Wog, Wog, Wwg, Wwg, Wwg, Wog, Wwg, Wog, Wwg, Wwg, Md, Md^Xm, Md^Xm, Md, Md, Md, Md, Md, Md, Md, Md, Md, Md, Md, Md, Md, Md, Md, Md, Md, Md, Md, Md, Md, Md, Md, Md, Md, Md, Md
Wwg, Wwg, Wwg, Wwg, Wwg, Wwg, Wwg, Wwg, Wwg, Wog, Wwg, Wog, Wwg, Wog, Wog, Wog, Wog, Wog, Wog, Wog, Wog, Wog, Wog, Wog, Wog, Wog, Wwg, Wog, Wwg, Wwg, Wwg, Wwg, Wwg, Wwg, Wwg, Wwg, Rrd, Wwg, Ds, Wwg, Rrd, Rrd, Md, Md, Md, Md^Xm, Md^Xm, Md, Md, Md, Md, Md, Md^Xm, Md, Md, Md, Md, Md, Md, Md, Md, Md, Md, Md, Md, Md, Md, Md, Md, Md, Md, Md
Wwg, Wwg, Wwg, Wwg, Wwg, Wwg, Wwg, Wwg, Wwg, Wwg, Wwg, Wwg, Wwg, Wwg, Wwg, Wwg, Wwg, Wog, Wwg, Wwg, Wwg, Wog, Wwg, Wwg, Wwg, Wwg, Wwg, Wwg, Wwg, Wwg, Re, Ds, Hhd^Dr, Rrd, Hhd, Rrd, Hhd^Dr, Ds, Gd, Rrd, Re, Re, Gd, Md, Md, Md, Md, Md^Xm, Md^Xm, Md, Md^Xm, Md^Xm, Md, Md^Xm, Md^Xm, Md, Md, Md, Md, Md, Md, Md, Md, Md, Md, Md, Md^Xm, Md, Md, Md, Md^Xm, Md^Xm
Rb, Ds, Ds^Tf, Wwg, Ss^Vm, Wwg, Ss, Wwg, Wwg, Wwg, Ds, Wwg, Wwg, Wwg, Wwg, Wwg, Wwg, Wwg, Wwg, Wwg, Wwg, Wwg, Wwg, Wwg, Wwg, Wwg, Rrd, Wwg, Rrd, Re, Gd, Ds, Gd, Hhd, Gd, Hhd^Dr, Re, Hhd, Hhd, Hhd^Dr, Hhd^Dr, Gd, Hhd, Gd, Gd, Md, Md, Md, Md, Md^Xm, Md, Gll^Fet, Gll^Fmw, Md, Md^Xm, Md, Md, Md, Md, Md, Md, Md, Md, Md, Md^Xm, Md^Xm, Md^Vhh, Md^Xm, Md^Xm, Md^Xm, Md^Xm, Md^Xm
Ss, Ss, Rb^Tf, Ds, Rb, Ss, Sm^Qhu, Ss, Ds, Ds, Ds^Tf, Ds, Ds, Wwg, Gd, Wwg, Ds, Ds, Hhd, Rrd, Rrd, Wwg, Wwg, Wwg, Rrd, Rrd, Gd, Rrd, Gd, Gd, Gd, Gd, Hhd, Gd, Hhd^Dr, Gd, Hhd^Dr, Re, Re, Hhd^Dr, Gd, Gd, Hhd, Hhd, Hhd^Dr, Hhd^Dr, Md, Md, Md, Md, Md, Md, Gll^Ve, Md, Md, Md^Xm, Md^Xm, Md, Md^Xm, Md, Md^Xm, Md, Md^Xm, Md^Xm, Md, Md, Md, Md, Md, Md^Xm, Md, Md
Sm^Qhu, Sm^Qhu, Chr, Chr, Chr, Ds, Ss, Sm^Qhu, Ss, Ss, Ss, Ds^Tf, Re^Gvs, Re^Gvs, Gd, Gd, Hhd^Dr, Hhd^Dr, Hhd, Hhd, Gd, Ds, Ds, Ds, Gd, Gd, Re, Re, Hhd^Dr, Hhd^Dr, Hhd, Re, Re, Gd, Re, Gd, Hhd^Dr, Hhd^Dr, Hhd, Gd, Hhd^Dr, Hhd^Dr, Gd, Hhd^Vhh, Hhd^Dr, Hhd^Dr, Hhd, Md, Gll^Fmw, Md, Gll^Fmw, Gll^Fmw, Gll^Fmw, Gll^Fmw, Md, Md, Md, Md^Xm, Md, Md^Xm, Md^Xm, Md^Xm, Md^Vhh, Md, Md, Md, Md, Md, Md, Md, Md, Md
Sm^Qhu, Ds, Chr, Khs, Chs, Rb, Sm^Qhu, Rb, Ds^Tf, Ss^Vhs, Sm^Qhu, Rd, Re^Gvs, Re^Gvs, Gd, Gd, Hhd, Hhd^Dr, Hhd^Dr, Gd, Hhd, Hhd^Vhh, Hhd^Dr, Gd, Re, Hhd^Dr, Hhd^Dr, Hhd, Re, Hhd^Dr, Re, Re, Hhd^Dr, Hhd, Hhd^Dr, Hhd^Dr, Gd, Hhd, Hhd, Hhd^Dr, Hhd^Dr, Gll^Fmw, Gll^Fmw, Gd, Hhd^Dr, Hhd, Gll^Fmw, Gll^Fmw, Gll^Fmw, Gll^Fmw, Hhd^Dr, Gll^Fmw, Gll^Fmw, Gll^Fmw, Md, Md, Md, Md, Md, Md^Xm, Md, Md, Md, Md, Md, Md, Md, Md, Md, Md, Md, Hhd
Ss, Rb^Tf, Rb^Tf, Chs, Ss, Rb, Sm^Qhu, Sm^Qhu, Ss, Ss, Sm^Qhu, Sm^Qhu, Gd, Hhd, Hhd, Gd, Hhd, Hhd^Dr, Gd, Hhd^Dr, Re, Hhd, Hhd, Hhd^Dr, Hhd, Hhd^Dr, Hhd^Dr, Gll^Fmw, Gll^Fmw, Hhd^Dr, Hhd^Dr, Hhd, Hhd, Hhd, Hhd^Dr, Hhd^Dr, Gd, Hhd, Re, Hhd^Dr, Hhd, Hhd, Hhd^Dr, Hhd^Dr, Re, Hhd, Re, Gll^Fmw, Gll^Fmw, Hhd, Hhd, Hhd^Dr, Hhd^Dr, Hhd, Hhd, Hhd, Hhd^Dr, Hhd^Dr, Hhd, Md, Hhd^Dr, Md, Hhd, Md, Hhd^Dr, Hhd^Dr, Hhd, Hhd, Hhd, Md, Hhd^Dr, Hhd^Dr
Rb, Ss, Ds, Rb, Ss, Ss, Re, Sm^Qhu, Ds, Ds, Gd, Gd, Hhd, Hhd, Hhd^Dr, Hhd, Hhd^Dr, Re, Re, Gd, Re, Re, Hhd, Re, Hhd, Hhd, Hhd^Dr, Gll^Fmw, Gll^Fmw, Re, Hhd^Dr, Hhd^Dr, Hhd, Re, Hhd, Gd, Hhd, Re, Re, Hhd^Dr, Hhd, Hhd, Rd, Hhd^Dr, Gd, Re, Re, Re, Gll^Fmw, Re, Gd, Hhd^Dr, Gd, Hhd, Hhd, Hhd, Hhd^Dr, Hhd^Dr, Gd, Hhd, Hhd^Dr, Hhd^Dr, Hhd, Hhd, Hhd^Dr, Hhd^Dr, Re, Hhd, Ce, Hhd, Hhd^Dr, Hhd^Dr
Rb, Ds^Tf, Rb^Tf, Ss, Sm^Qhu, Ss^Vhs, Re^Tf, Re^Tf, Ds, Re^Vc, Hhd^Dr, Hhd^Dr, Re, Re, Hhd^Dr, Hhd^Dr, Hhd^Dr, Hhd^Dr, Gll^Fmw, Hhd^Dr, Hhd^Dr, Hhd, Hhd^Dr, Hhd^Dr, Hhd, Hhd, Hhd^Dr, Hhd^Dr, Gll^Fmw, Re^Vh, Hhd, Re, Hhd^Dr, Hhd^Dr, Hhd, Hhd, Hhd^Dr, Re, Hhd^Dr, Hhd, Re, Re, Gd, Hhd, Re, Gd, Gd, Gll^Fmw, Gll^Fmw, Re, Re, Gd, Re, Gd, Rd, Hhd^Dr, Rd, Rd, Rd, Hhd^Dr, Re, Gd, Re, Gd, Rd, Re, Rd, Ce, 1 Ke, Ce, Hhd, Hhd
Ss, Ds, Ss, Ss, Sm^Qhu, Ds, Ds, Re^Tf, Re, Gd, Hhd^Dr, Gd, Hhd, Hhd^Dr, Hhd^Dr, Hhd, Gll^Fmw, Gll^Fmw, Gll^Fmw, Hhd, Hhd, Hhd, Hhd^Dr, Hhd^Dr, Re, Hhd, Hhd, Re, Re, Hhd, Re, Hhd^Dr, Hhd^Dr, Hhd, Re, Re, Hhd^Dr, Hhd^Dr, Hhd^Dr, Hhd, Rd, Rd, Gd, Gd, Gd, Re, Re, Gll^Fmw, Gll^Fmw, Gll^Fmw, Gll^Fmw, Re, Rd, Rd, Rd, Rd, Gd, Re, Rd, Hhd^Dr, Hhd, Re, Rd, Rd, Re, Rd, Rd, Ce, Ce, Ce, Hhd^Dr, Hhd
Gd, Ss, Rd, Sm^Qhu, Gd, Ds, Re, Re, Gd, Gd, Gd, Hhd, Gll^Fmw, Gll^Fmw, Gll^Fmw, Hhd, Gll^Fmw, Hhd, Hhd, Hhd^Dr, Hhd^Dr, Re, Hhd^Dr, Hhd, Hhd, Re, Hhd, Hhd, Hhd, Hhd, Hhd^Dr, Hhd^Dr, Hhd, Hhd, Rd, Hhd, Hhd, Re, Hhd, Hhd, Hhd^Dr, Hhd^Dr, Gd, Re, Gd, Re^Vh, Gd, Gll^Fmw, Gll^Fmw, Gll^Fmw, Gll^Fmw, Gd, Re, Gd, Hhd^Dr, Gd, Hhd, Gd, Hhd, Gll^Vh, Hhd, Rd, Hhd^Dr, Gd, Hhd^Dr, Gd, Re, Gd, Gd, Hhd^Dr, Hhd^Dr, Hhd
Gd, Gd, Gd, Gd, Rp, Rd, Rd, Rd, Gd, Gd, Gd, Rd, Rd, Gll^Fmw, Hhd^Dr, Hhd^Dr, Re, Rd, Rd, Rd, Hhd^Dr, Rd, Rd, Hhd, Hhd^Dr, Hhd^Dr, Rd, Rd, Re, Hhd, Hhd^Dr, Hhd^Dr, Rd, Hhd, Hhd^Dr, Hhd, Rd, Re, Re, Rd, Hhd^Dr, Hhd^Dr, Hhd, Gd, Hhd^Dr, Re, Gd, Gll^Fmw, Re^Ve, Gll^Fmw, Gd, Re, Hhd, Hhd^Dr, Hhd^Dr, Hhd, Hhd, Hhd^Dr, Hhd^Dr, Hhd^Dr, Hhd^Dr, Hhd, Hhd^Dr, Hhd^Dr, Hhd, Hhd, Hhd, Hhd, Hhd^Dr, Hhd^Dr, Md, Hhd
Rr, Rr, Rr, Rp, Gd, Rr, Re, Gd, Gd, Re, Re, Gd, Re, Gll^Fmw, Re, Re, Hhd^Dr, Hhd^Dr, Hhd, Hhd, Hhd^Dr, Hhd^Dr, Gll^Fmw, Hhd, Re, Hhd^Dr, Hhd^Dr, Re, Hhd, Hhd, Hhd, Hhd, Hhd, Rd, Hhd^Dr, Hhd^Dr, Hhd, Hhd, Hhd^Dr, Hhd^Dr, Gd, Hhd, Gd, Re, Hhd^Dr, Gd, Hhd^Dr, Re, Hhd, Hhd^Dr, Hhd, Hhd, Hhd^Dr, Hhd^Dr, Md, Hhd, Hhd, Hhd, Md, Hhd^Dr, Hhd, Hhd, Hhd, Hhd^Dr, Md, Hhd, Md, Hhd^Dr, Md, Md^Vhh, Md, Md
Hhd, Hhd, Re, Gd, Gd, Re, Gd, Re, Re, Re, Re, Gd, Gd, Re, Hhd^Dr, Hhd, Gd, Hhd^Dr, Hhd^Dr, Re, Hhd, Hhd^Dr, Hhd, Hhd, Hhd, Re, Hhd^Dr, Hhd^Dr, Hhd, Re, Hhd^Dr, Re, Re, Gll^Fmw, Hhd^Dr, Re^Vh, Hhd, Hhd, Hhd^Dr, Hhd^Dr, Hhd, Gd, Gd, Re, Hhd, Hhd, Hhd^Dr, Hhd^Dr, Hhd, Hhd^Dr, Md, Md, Md, Md, Md, Md, Md, Md, Md, Md, Md, Md, Md, Md, Md, Md, Md, Md, Md, Md, Md^Xm, Md
Gd, Hhd, Gd, Re, Re, Re, Gd, Re, Gd, Re, Gd, Gd, Hhd, Hhd^Dr, Gd, Re, Gd, Hhd^Dr, Hhd^Dr, Re, Hhd, Re, Hhd, Hhd, Hhd^Dr, Re, Cer, Cer, Cer, Re, Hhd^Dr, Hhd^Dr, Hhd, Gll^Fmw, Hhd, Re, Hhd, Re, Hhd, Hhd, Gd, Re, Gd, Gll^Fmw, Gll^Fmw, Gll^Fmw, Hhd, Hhd^Dr, Hhd, Hhd, Md, Md, Md, Md, Md, Md, Md, Md, Md, Md, Md^Xm, Md, Md^Xm, Md, Md, Md, Md, Md, Md^Xm, Md^Xm, Md, Md^Xm
Gd, Gd, Gd, Re, Re^Vh, Re, Re, Re, Gd, Hhd^Dr, Hhd^Dr, Hhd, Hhd^Dr, Gd, Re, Re, Gd, Re, Re, Re, Hhd^Dr, Hhd^Dr, Re, Hhd, Hhd^Dr, Hhd^Dr, Cer, Ker, Cer, Hhd, Hhd, Hhd^Dr, Hhd^Dr, Hhd, Hhd, Re, Hhd^Dr, Hhd, Hhd, Gd, Re, Gd, Hhd^Dr, Gll^Fmw, Hhd, Hhd, Hhd, Hhd^Dr, Md, Md, Md^Xm, Md^Xm, Md^Xm, Md, Md, Md, Md^Xm, Md, Md, Md^Xm, Md^Xm, Md^Xm, Md^Xm, Md^Xm, Md, Md, Md, Md, Md^Xm, Md, Md, Md
Gd, Re, Gd, Gd, Re^Gvs, Re^Gvs, Re^Gvs, Gd, Hhd, Hhd^Dr, Gd, Hhd^Dr, Hhd^Dr, Gd, Hhd, Hhd, Gd, Gd, Hhd, Re^Vh, Hhd, Re, Re, Hhd, Hhd^Dr, Re, Hhd, Cer, Re, Hhd, Hhd, Hhd^Dr, Hhd^Dr, Hhd, Hhd, Hhd^Dr, Hhd^Dr, Gd, Hhd^Dr, Re, Hhd, Hhd, Hhd^Dr, Hhd^Dr, Md, Hhd, Md^Xm, Md, Md^Xm, Md^Xm, Md^Xm, Md^Xm, Md, Md^Xm, Md^Xm, Md^Xm, Md, Md^Xm, Md^Xm, Md^Xm, Md, Md, Md, Md^Xm, Md^Xm, Md, Md^Xm, Md^Xm, Md, Md, Md, Md
Re, Gd, Re^Gvs, Re^Gvs, Re^Gvs, Re^Gvs, Re^Gvs, Re^Gvs, Re, Gd, Gd, Gd, Gd, Hhd^Dr, Gd, Hhd, Gd, Gd, Hhd, Hhd, Hhd^Dr, Hhd^Dr, Hhd^Dr, Hhd^Dr, Hhd^Dr, Re, Hhd^Dr, Re, Hhd, Hhd, Hhd, Gll^Fmw, Gll^Fmw, Hhd^Dr, Hhd, Gll^Fmw, Gll^Fmw, Hhd^Dr, Hhd^Dr, Gd, Hhd, Hhd^Dr, Hhd^Dr, Md, Md, Md, Md^Xm, Md^Xm, Md^Xm, Md, Md, Md, Md, Md, Md, Md, Md, Md, Md, Md, Md, Md, Md, Md, Md, Md^Xm, Md^Xm, Md^Xm, Md^Xm, Md, Md, Md
Gd, Re^Gvs, Re^Gvs, Re^Gvs, Re^Gvs, Re^Gvs, Gd, Gd, Gd, Gd, Hhd^Dr, Hhd^Dr, Hhd, Hhd^Dr, Hhd, Hhd^Dr, Hhd^Dr, Gd, Gd, Hhd, Re, Hhd^Dr, Gd, Gd, Hhd, Hhd^Dr, Hhd, Re, Hhd, Hhd, Gd, Gd, Gll^Fmw, Gll^Fmw, Gll^Fmw, Gll^Fmw, Hhd, Hhd, Hhd^Dr, Hhd^Dr, Hhd, Gd, Hhd, Md, Md, Md^Xm, Md^Xm, Md, Md, Md, Md, Md, Md, Md, Md, Md, Md, Md, Md, Md, Md, Md, Mm^Xm, Md, Md, Md, Md, Md, Md, Md^Xm, Md^Xm, Md
Gs, Gd, Gd, Re^Gvs, Gs, Gd, Gd, Re, Gd, Gd, Gd, Hhd^Dr, Gd, Gd, Re, Re, Re, Gd, Gs, Gd, Re, Gd, Re, Gd, Gd, Gd, Gd, Re, Gs, Gd, Re, Re, Gs, Re, Gd, Gd, Gs, Gd, Gd, Gd, Gd, Hhd, Hhd, Md, Md, Md^Xm, Md^Xm, Md, Md, Md, Md, Md, Md, Md, Md, Md, Md, Md, Md, Md, Md, Md, Md, Md, Md, Md, Md, Md, Md, Md, Md, Md^Xm
