Xos, Rr, Rr, Xos, Xos, Xos, Xos, Xos, Xos, Xos, Xos, Xos, Xos, Xos, Xos, Xos, Xos, Xos, Xos, Xos, Xos, Xos, Xos, Xos, Xos, Xos, Xos, Xos, Xos, Xos, Gs^Fp, Gs^Fp, Gs^Fp, Gg, Gg, Gg, Ww, Ww
Xos, Xos, Xos, Rr, Rr, Xos, Xos, Xos, Xos, Xos, Xos, Xos, Rr, Xos, Xos, Xos, Xos, Xos, Xos, Xos, Xos, Xos, Xos, Xos, Xos, Xos, Xos, Xos, Xos, Xos, Gs^Fp, Gs^Fp, Gs^Fp, Gs^Fp, Gg, Ds, Ww, Ww
Xos, Xos, Xos, Xos, Xos, Rr, Rr, Xos, Xos, Xos, Rr, Rr, Rr, Rr, Rr, Xos, Xos, Xos, Xos, Xos, Xos, Xos, Xos, Xos, Xos, Xos, Xos, Xos, Xos, Xos, Gs, Gs, Gs^Fp, Gg, Gg, Ds, Ww, Ww
Xos, Xos, Xos, Xos, Xos, Xos, Xos, Rr, Rr, Rr, Rr, Rr, Rr, Rr, Rr, Rr, Rr, Xos, Xos, Xos, Xos, Xos, Xos, Xos, Xos, Xos, Xos, Xos, Xos, Xos, Gs^Fp, Gs, Gs, Gs^Fp, Gg, Gg, Ww, Ww
Xos, Xos, Xos, Xos, Xos, Xos, Rr, Rr, Isa, Isa, Rr, Rr, Rb, Rr, Rr, Isa, Isa, Rb, Rb, Xos, Xos, Xos, Xos, Xos, Xos, Xos, Xos, Xos, Xos, Xos, Gs^Fp, Gs^Ve, Gs^Fp, Gs^Fp, Gg, Gg, Ww, Ww
Xos, Xos, Xos, Xos, Rr, Rr, Rr, Isa, Isa, Isa, Rb, Rb, Rb, Rb, Rb, Rr, Rr, Isa, Rb, Rr, Rr, Xos, Xos, Xos, Xos, Xos, Xos, Xos, Xos, Xos, Gs, Gs, Gs^Fp, Gs^Fp, Gs^Fp, Ds, Ww, Ww
Xos, Xos, Xos, Xos, Rr, Rr, Rr, Rr, Rb, Rb, Isa, Rb, Rr, Rr, Isa, Rb, Rb, Rr, Rr, Rb, Rr, Xos, Xos, Xos, Xos, Xos, Xos, Xos, Xos, Xos, Gg, Gs, Gg, Gs^Fp, Gg, Ds, Ss, Ww
Xos, Xos, Xos, Xos, Isa, Rr, Rr, Rb, Isa, Isa, Kh, Ch, Rb, Isa, Isa, Isa, Rb, Rb, Rr, Rr, Rb, Xos, Xos, Xos, Xos, Xos, Xos, Xos, Rb, Xos, Gg, Gg, Rd, Gg, Gg, Gg, Ss, Ss
Xos, Xos, Xos, Xos, Isa, Rr, Rr, Isa, Isa, Isa, Ch, Ch, Rr, Isa, Rb, Isa, Isa, Rb, Isa, Rb, Rb, Rb, Rb, Xos, Xos, Xos, Rr, Rb, Rr, Ch, Gg, Gg, Gg, Rd, Rd, Gg, Gg, Gg
Xos, Xos, Xos, Xos, Isa, Rr, Rr, Isa, Rb, Rb, Rr, Rr, Rb, Rb, Rr, Rb, Rb, Rb, Rr, Rr, Rr, Rr, Rr, Rb, Rr, Rr, Rb, Rr, Isa, Rr, Gg, Gg, Rr, Rr, Rr, Rd, 1 Gg, Gg
Rr, Rr, Rr, Rr, Isa, Rr, Rr, Rb, Rr, Rr, Rr, Rr, Rr, Rr, Rb, Rr, Rr, Rr, Rr, Rr, Rb, Rb, Isa, Rr, Rb, Rb, Xos, Xos, Xos, Ch, Gg, Gg, Gg, Gg, Gg, Rr, Rr, Gg
Xos, Xos, Xos, Xos, Rr, Isa, Rr, Rr, Rb, Rb, Isa, Isa, Isa, Rr, Rb, Rb, Rb, Rr, Rb, Rb, Rr, Xos, Xos, Rb, Xos, Xos, Xos, Xos, Xos, Xos, Gg, Gg, Gg, Gg, Gg, Gg, Gg, Rr
Xos, Xos, Xos, Xos, Rr, Rr, Rr, Rr, Isa, Isa, Rr, Rr, Rr, Rb, Isa, Isa, Isa, Rb, Isa, Rb, Rr, Xos, Xos, Xos, Xos, Xos, Xos, Xos, Xos, Xos, Gg, Gg, Gg, Gg, Re, Gg, Gg, Gg
Xos, Xos, Xos, Xos, Rr, Rb, Rr, Rb, Isa, Rr, Isa, Rr, Isa, Rb, Isa, Isa, Isa, Isa, Rr, Rr, Rr, Xos, Xos, Xos, Xos, Xos, Xos, Xos, Xos, Xos, Gg, Gg, Gg, Re, Gg^Vh, Gs^Fp, Gs^Fp, Gg
Xos, Xos, Xos, Xos, Rr, Rb, Rr, Rb, Rb, Isa, Rr, Isa, Rr, Rb, Rr, Rr, Rr, Rr, Rr, Rr, Rr, Xos, Xos, Xos, Xos, Xos, Xos, Xos, Xos, Xos, Gg, Gg, Gg, Re, Gg, Gs^Fp, Gs^Fp, Gs^Fp
Xos, Xos, Xos, Xos, Rr, Rb, Rb, Rr, Rr, Rb, Rr, Rr, Rr, Rr, Rb, Isa, Rr, Rr, Rb, Rr, Rr, Xos, Xos, Xos, Xos, Xos, Xos, Xos, Xos, Xos, Gg, Gg, Gg, Re, Gg, Gg, Gg, Gs^Fp
Xos, Xos, Xos, Xos, Xos, Rr, Rr, Rb, Rb, Rr, Rr, Rr, Rr, Rr, Rr, Rr, Rr, Rb, Rr, Rr, Xos, Xos, Xos, Xos, Xos, Xos, Xos, Xos, Xos, Xos, Gg, Gg, Gg, Re, Re, Gg, Gg, Ww
Xos, Xos, Xos, Xos, Xos, Xos, Rr, Rr, Rr, Rr, Rr, Rr, Isa, Rr, Isa, Rr, Isa, Rr, Xos, Xos, Xos, Xos, Xos, Xos, Xos, Xos, Xos, Xos, Xos, Xos, Gg, Gg^Vh, Gs^Fp, Gg, Gg, Re, Ww^Bw\, Ww
Xos, Xos, Xos, Xos, Rr, Rr, Xos, Xos, Xos, Rr, Rr, Rr, Rr, Isa, Rr, Isa, Xos, Xos, Xos, Xos, Xos, Xos, Xos, Xos, Xos, Xos, Xos, Xos, Xos, Xos, Gg, Gg, Gs^Fp, Gs^Fp, Gs^Fp, Gs^Fp, Ww, Ww
Xos, Xos, Rr, Rr, Xos, Xos, Xos, Xos, Xos, Xos, Xos, Rr, Rr, Rr, Xos, Xos, Xos, Xos, Xos, Xos, Xos, Xos, Xos, Xos, Xos, Xos, Xos, Xos, Xos, Xos, Gs^Fp, Gs^Fp, Gs^Fp, Gs^Fp, Gs^Fp, Gs^Fp, Ww, Ww
Rr, Rr, Xos, Xos, Xos, Xos, Xos, Xos, Xos, Xos, Xos, Xos, Xos, Xos, Xos, Xos, Xos, Xos, Xos, Xos, Xos, Xos, Xos, Xos, Xos, Xos, Xos, Xos, Xos, Xos, Gs^Fp, Gs^Fp, Gs^Fp, Gs^Fp, Ds, Ds, Ww, Ww
Xos, Xos, Xos, Xos, Xos, Xos, Xos, Xos, Xos, Xos, Xos, Xos, Xos, Xos, Xos, Xos, Xos, Xos, Xos, Xos, Xos, Xos, Xos, Xos, Xos, Xos, Xos, Xos, Xos, Xos, Gs, Gs, Gg, Gs^Fp, Gg, Ds, Ww, Ww
