Xos, Rr, Rr, Xos, Xos, Xos, Xos, Xos, Xos, Xos, Xos, Xos, Xos, Xos, Xos, Xos, Xos, Xos, Xos, Xos, Xos, Xos, Xos, Gs^Fp, Gs^Fp, Gg, Gs^Fp, Gg, Gs^Fp, Gs^Fp, Gs^Fp, Gs^Fp, Gs^Fp, Gg, Gg, Gg, Ww, Ww
Xos, Xos, Xos, Rr, Rr, Xos, Xos, Xos, Xos, Xos, Xos, Xos, Rr, Xos, Xos, Xos, Xos, Xos, Xos, Xos, Xos, Xos, Xos, Xos, Xos, Gs^Fp, Gs^Fp, Gs^Fp, Gs^Fp, Gs^Fp, Gs^Fp, Gs^Fp, Gs^Fp, Gs^Fp, Gg, Ds, Ww, Ww
Xos, Xos, Xos, Xos, Xos, Rr, Rr, Xos, Xos, Xos, Rr, Rr, Rr, Rr, Rr, Xos, Xos, Xos, Xos, Xos, Xos, Xos, Xos, Xos, Xos, Gs^Fp, Gs^Fp, Gs^Fp, Gs^Fp, Gs^Fp, Gg, Gg, Gs^Fp, Gg, Gg, Ds, Ww, Ww
Xos, Xos, Xos, Xos, Xos, Xos, Xos, Rr, Rr, Rr, Rr, Rr, Rr, Rr, Rr, Rr, Rr, Xos, Xos, Xos, Xos, Xos, Xos, Xos, Xos, Gg, Gg, Gg, Gg, Gs^Fp, Gs^Fp, Gg, Gg, Gs^Fp, Gg, Gg, Ww, Ww
Xos, Xos, Xos, Xos, Xos, Xos, Rr, Rr, Rr, Rp, Rr, Rr, Rd, Rr, Rr, Rp, Rd, Rd, Rd, Xos, Xos, Xos, Xos, Xos, Xos, Xos, Xos, Gg, Gg, Gg, Gs^Fp, Gg^Ve, Gs^Fp, Gs^Fp, Gg, Gg, Ww, Ww
Xos, Xos, Xos, Xos, Rr, Rr, Rr, Rr, Rr, Rr, Rd, Rd, Rd, Rd, Rd, Rr, Rr, Rp, Rd, Rr, Rr, Xos, Xos, Xos, Xos, Xos, Xos, Xos, Xos, Gg, Gg, Gg, Gs^Fp, Gs^Fp, Gs^Fp, Ds, Ww, Ww
Xos, Xos, Xos, Xos, Rr, Rr, Rr, Rr, Rd, Rd, Rp, Rd, Rr, Rr, Rp, Rd, Rd, Rr, Rr, Rd, Rr, Xos, Xos, Xos, Xos, Xos, Xos, Xos, Xos, Gg, Gg, Gg, Gg, Gs^Fp, Gg, Ds, Ss, Ww
Xos, Xos, Xos, Xos, Rp, Rr, Rr, Rd, Rp, Rp, Kh, Ch, Rd, Rp, Rp, Rp, Rd, Rd, Rr, Rr, Re, Xos, Xos, Xos, Xos, Xos, Xos, Xos, Rd, Xos, Gg, Gg, Rd, Gg, Gg, Gg, Ss, Ss
Xos, Xos, Xos, Xos, Rp, Rr, Rr, Rp, Rp, Rp, Ch, Ch, Rr, Rp, Rd, Rp, Rp, Rd, Rp, Re, Re, Re, Re, Xos, Xos, Xos, Rr, Rd, Rr, Ch, Gg, Gg, Gg, Rd, Rd, Gg, Gg, Gg
Xos, Xos, Xos, Xos, Rp, Rr, Rr, Rp, Rd, Rd, Rr, Rr, Rd, Rd, Rr, Rd, Rd, Rd, Rr, Rr, Rr, Rr, Rr, Re, Rr, Rr, Rd, Rr, Gg, Rr, Gg, Gg, Rr, Rr, Rr, Rd, 1 Gg, Gg
Rr, Rr, Rr, Rr, Rp, Rr, Rr, Rd, Rr, Rr, Rr, Rr, Rr, Rr, Rd, Rr, Rr, Rr, Rr, Rr, Re, Re, Gg, Rr, Rd, Rd, Xos, Xos, Xos, Ch, Gg, Gg, Gg, Gg, Gg, Rr, Rr, Gg
Xos, Xos, Xos, Xos, Rr, Rp, Rr, Rr, Rd, Rd, Rp, Rp, Rp, Rr, Rd, Rd, Rd, Rr, Rd, Re, Rr, Xos, Xos, Rd, Xos, Xos, Xos, Xos, Xos, Xos, Gg, Gg, Gg, Gg, Gg, Gg, Gg, Rr
Xos, Xos, Xos, Xos, Rr, Rr, Rr, Rr, Rp, Rp, Rr, Rr, Rr, Rd, Rp, Rp, Rp, Rd, Rp, Rd, Rr, Xos, Xos, Xos, Xos, Xos, Xos, Xos, Xos, Xos, Gg, Gg, Gg, Gg, Re, Gg, Gg, Gg
Xos, Xos, Xos, Xos, Rr, Rd, Rr, Rd, Rp, Rr, Rp, Rr, Rp, Rd, Rp, Rp, Rp, Rp, Rr, Rr, Rr, Xos, Xos, Xos, Xos, Xos, Xos, Xos, Xos, Xos, Gg, Gg, Gg, Re, Gg^Vh, Gs^Fp, Gs^Fp, Gg
Xos, Xos, Xos, Xos, Rr, Rd, Rr, Rd, Rd, Rp, Rr, Rp, Rr, Rd, Rr, Rr, Rr, Rr, Rr, Rr, Rr, Xos, Xos, Xos, Xos, Xos, Xos, Xos, Xos, Xos, Gg, Gg, Gg, Re, Gg, Gs^Fp, Gs^Fp, Gs^Fp
Xos, Xos, Xos, Xos, Rr, Rd, Rd, Rr, Rr, Rd, Rr, Rr, Rr, Rr, Rd, Rp, Rr, Rr, Rd, Rr, Rr, Xos, Xos, Xos, Xos, Xos, Xos, Xos, Xos, Xos, Gg, Gg, Gg, Re, Gg, Gg, Gg, Gs^Fp
Xos, Xos, Xos, Xos, Xos, Rr, Rr, Rd, Rd, Rr, Rr, Rr, Rr, Rr, Rr, Rr, Rr, Rd, Rr, Rr, Xos, Xos, Xos, Xos, Xos, Xos, Xos, Xos, Xos, Xos, Gg, Gg, Gg, Re, Re, Gg, Gg, Ww
Xos, Xos, Xos, Xos, Xos, Xos, Rr, Rr, Rr, Rr, Rr, Rr, Rp, Rr, Rp, Rr, Rp, Rr, Xos, Xos, Xos, Xos, Xos, Xos, Xos, Xos, Xos, Xos, Xos, Xos, Gg, Gg^Vh, Gs^Fp, Gg, Gg, Re, Ww^Bw\, Ww
Xos, Xos, Xos, Xos, Rr, Rr, Xos, Xos, Xos, Rr, Rr, Rr, Rr, Rp, Rr, Rp, Xos, Xos, Xos, Xos, Xos, Xos, Xos, Xos, Xos, Xos, Xos, Xos, Xos, Gg, Gg, Gg, Gs^Fp, Gs^Fp, Gs^Fp, Gs^Fp, Ww, Ww
Xos, Xos, Rr, Rr, Xos, Xos, Xos, Xos, Xos, Xos, Xos, Rr, Rr, Rr, Xos, Xos, Xos, Xos, Xos, Xos, Xos, Xos, Xos, Xos, Xos, Xos, Xos, Xos, Gg, Gg, Gs^Fp, Gs^Fp, Gs^Fp, Gs^Fp, Gs^Fp, Gs^Fp, Ww, Ww
Rr, Rr, Xos, Xos, Xos, Xos, Xos, Xos, Xos, Xos, Xos, Xos, Xos, Xos, Xos, Xos, Xos, Xos, Xos, Xos, Xos, Xos, Xos, Xos, Xos, Xos, Xos, Xos, Gg, Gs^Fp, Gs^Fp, Gs^Fp, Gs^Fp, Gs^Fp, Ds, Ds, Ww, Ww
Xos, Xos, Xos, Xos, Xos, Xos, Xos, Xos, Xos, Xos, Xos, Xos, Xos, Xos, Xos, Xos, Xos, Xos, Xos, Xos, Xos, Xos, Xos, Xos, Xos, Xos, Xos, Xos, Gg, Gg, Gg, Gg, Gg, Gs^Fp, Gg, Ds, Ww, Ww
