Xos, Rra, Rra, Xos, Xos, Xos, Xos, Xos, Xos, Xos, Xos, Xos, Xos, Xos, Xos, Xos, Xos, Xos, Xos, Xos, Xos, Xos, Xos, Xos, Xos, Xos, Xos, Xos, Xos, Xos, Gs^Fp, Gs^Fp, Gs^Fp, Gg, Gg, Gg, Ww, Ww
Xos, Xos, Xos, Rra, Rra, Xos, Xos, Xos, Xos, Xos, Xos, Xos, Rra, Xos, Xos, Xos, Xos, Xos, Xos, Xos, Xos, Xos, Xos, Xos, Xos, Xos, Xos, Xos, Xos, Xos, Gs^Fp, Gs^Fp, Gs^Fp, Gs^Fp, Gg, Ds, Ww, Ww
Xos, Xos, Xos, Xos, Xos, Rra, Rra, Xos, Xos, Xos, Rra, Rra, Rra, Rra, Rra, Xos, Xos, Xos, Xos, Xos, Xos, Xos, Xos, Xos, Xos, Xos, Xos, Xos, Xos, Xos, Gg, Gg, Gs^Fp, Gg, Gg, Ds, Ww, Ww
Xos, Xos, Xos, Xos, Xos, Xos, Xos, Rra, Rra, Rra, Rra, Rra, Rra, Rra, Rra, Rra, Rra, Xos, Xos, Xos, Xos, Xos, Xos, Xos, Xos, Xos, Xos, Xos, Xos, Xos, Gs^Fp, Gg, Gg, Gs^Fp, Gg, Gg, Ww, Ww
Xos, Xos, Xos, Xos, Xos, Xos, Rra, Rra, Rra, Ias, Rra, Rra, Rb, Rra, Rra, Ias, Rb, Rb, Rb, Xos, Xos, Xos, Xos, Xos, Xos, Xos, Xos, Xos, Xos, Xos, Gs^Fp, Gg^Ve, Gs^Fp, Gs^Fp, Gg, Gg, Ww, Ww
Xos, Xos, Xos, Xos, Rra, Rra, Rra, Rra, Rra, Rra, Rb, Rb, Rb, Rb, Rb, Rra, Rra, Ias, Rb, Rra, Rra, Xos, Xos, Xos, Xos, Xos, Xos, Xos, Xos, Xos, Gg, Gg, Gs^Fp, Gs^Fp, Gs^Fp, Ds, Ww, Ww
Xos, Xos, Xos, Xos, Rra, Rra, Rra, Rra, Rb, Rb, Ias, Rb, Rra, Rra, Ias, Rb, Rb, Rra, Rra, Rb, Rra, Xos, Xos, Xos, Xos, Xos, Xos, Xos, Xos, Xos, Gg, Gg, Gg, Gs^Fp, Gg, Ds, Ss, Ww
Xos, Xos, Xos, Xos, Ias, Rra, Rra, Rb, Ias, Ias, Kh, Ch, Rb, Ias, Ias, Ias, Rb, Rb, Rra, Rra, Rb, Xos, Xos, Xos, Xos, Xos, Xos, Xos, Rb, Xos, Gg, Gg, Rd, Gg, Gg, Gg, Ss, Ss
Xos, Xos, Xos, Xos, Ias, Rra, Rra, Ias, Ias, Ias, Ch, Ch, Rra, Ias, Rb, Ias, Ias, Rb, Ias, Rb, Rb, Rb, Rb, Xos, Xos, Xos, Rra, Rb, Rra, Ch, Gg, Gg, Gg, Rd, Rd, Gg, Gg, Gg
Xos, Xos, Xos, Xos, Ias, Rra, Rra, Ias, Rb, Rb, Rra, Rra, Rb, Rb, Rra, Rb, Rb, Rb, Rra, Rra, Rra, Rra, Rra, Rb, Rra, Rra, Rb, Rra, Ias, Rra, Gg, Gg, Rr, Rr, Rr, Rd, 1 Gg, Gg
Rra, Rra, Rra, Rra, Ias, Rra, Rra, Rb, Rra, Rra, Rra, Rra, Rra, Rra, Rb, Rra, Rra, Rra, Rra, Rra, Rb, Rb, Ias, Rra, Rb, Rb, Xos, Xos, Xos, Ch, Gg, Gg, Gg, Gg, Gg, Rr, Rr, Gg
Xos, Xos, Xos, Xos, Rra, Ias, Rra, Rra, Rb, Rb, Ias, Ias, Ias, Rra, Rb, Rb, Rb, Rra, Rb, Rb, Rra, Xos, Xos, Rb, Xos, Xos, Xos, Xos, Xos, Xos, Gg, Gg, Gg, Gg, Gg, Gg, Gg, Rr
Xos, Xos, Xos, Xos, Rra, Rra, Rra, Rra, Ias, Ias, Rra, Rra, Rra, Rb, Ias, Ias, Ias, Rb, Ias, Rb, Rra, Xos, Xos, Xos, Xos, Xos, Xos, Xos, Xos, Xos, Gg, Gg, Gg, Gg, Re, Gg, Gg, Gg
Xos, Xos, Xos, Xos, Rra, Rb, Rra, Rb, Ias, Rra, Ias, Rra, Ias, Rb, Ias, Ias, Ias, Ias, Rra, Rra, Rra, Xos, Xos, Xos, Xos, Xos, Xos, Xos, Xos, Xos, Gg, Gg, Gg, Re, Gg^Vh, Gs^Fp, Gs^Fp, Gg
Xos, Xos, Xos, Xos, Rra, Rb, Rra, Rb, Rb, Ias, Rra, Ias, Rra, Rb, Rra, Rra, Rra, Rra, Rra, Rra, Rra, Xos, Xos, Xos, Xos, Xos, Xos, Xos, Xos, Xos, Gg, Gg, Gg, Re, Gg, Gs^Fp, Gs^Fp, Gs^Fp
Xos, Xos, Xos, Xos, Rra, Rb, Rb, Rra, Rra, Rb, Rra, Rra, Rra, Rra, Rb, Ias, Rra, Rra, Rb, Rra, Rra, Xos, Xos, Xos, Xos, Xos, Xos, Xos, Xos, Xos, Gg, Gg, Gg, Re, Gg, Gg, Gg, Gs^Fp
Xos, Xos, Xos, Xos, Xos, Rra, Rra, Rb, Rb, Rra, Rra, Rra, Rra, Rra, Rra, Rra, Rra, Rb, Rra, Rra, Xos, Xos, Xos, Xos, Xos, Xos, Xos, Xos, Xos, Xos, Gg, Gg, Gg, Re, Re, Gg, Gg, Ww
Xos, Xos, Xos, Xos, Xos, Xos, Rra, Rra, Rra, Rra, Rra, Rra, Ias, Rra, Ias, Rra, Ias, Rra, Xos, Xos, Xos, Xos, Xos, Xos, Xos, Xos, Xos, Xos, Xos, Xos, Gg, Gg^Vh, Gs^Fp, Gg, Gg, Re, Ww^Bw\, Ww
Xos, Xos, Xos, Xos, Rra, Rra, Xos, Xos, Xos, Rra, Rra, Rra, Rra, Ias, Rra, Ias, Xos, Xos, Xos, Xos, Xos, Xos, Xos, Xos, Xos, Xos, Xos, Xos, Xos, Xos, Gg, Gg, Gs^Fp, Gs^Fp, Gs^Fp, Gs^Fp, Ww, Ww
Xos, Xos, Rra, Rra, Xos, Xos, Xos, Xos, Xos, Xos, Xos, Rra, Rra, Rra, Xos, Xos, Xos, Xos, Xos, Xos, Xos, Xos, Xos, Xos, Xos, Xos, Xos, Xos, Xos, Xos, Gs^Fp, Gs^Fp, Gs^Fp, Gs^Fp, Gs^Fp, Gs^Fp, Ww, Ww
Rra, Rra, Xos, Xos, Xos, Xos, Xos, Xos, Xos, Xos, Xos, Xos, Xos, Xos, Xos, Xos, Xos, Xos, Xos, Xos, Xos, Xos, Xos, Xos, Xos, Xos, Xos, Xos, Xos, Xos, Gs^Fp, Gs^Fp, Gs^Fp, Gs^Fp, Ds, Ds, Ww, Ww
Xos, Xos, Xos, Xos, Xos, Xos, Xos, Xos, Xos, Xos, Xos, Xos, Xos, Xos, Xos, Xos, Xos, Xos, Xos, Xos, Xos, Xos, Xos, Xos, Xos, Xos, Xos, Xos, Xos, Xos, Gg, Gg, Gg, Gs^Fp, Gg, Ds, Ww, Ww
