Xos, Rra, Rra, Xos, Xos, Xos, Xos, Xos, Xos, Xos, Xos, Xos, Xos, Xos, Xos, Xos, Xos, Xos, Xos, Xos, Xos, Xos, Xos, Xos, Xos, Xos, Xos, Xos, Xos, Xos, Gs^Fp, Gs^Fp, Gs^Fp, Gg, Gg, Gg, Ww, Ww
Xos, Xos, Xos, Rra, Rra, Xos, Xos, Xos, Xos, Xos, Xos, Xos, Rra, Xos, Xos, Xos, Xos, Xos, Xos, Xos, Xos, Xos, Xos, Xos, Xos, Xos, Xos, Xos, Xos, Xos, Gs^Fp, Gs^Fp, Gs^Fp, Gs^Fp, Gg, Ds, Ww, Ww
Xos, Xos, Xos, Xos, Xos, Rra, Rra, Xos, Xos, Xos, Rra, Rra, Rra, Rra, Rra, Xos, Xos, Xos, Xos, Xos, Xos, Xos, Xos, Xos, Xos, Xos, Xos, Xos, Xos, Xos, Gg, Gg, Gs^Fp, Gg, Gg, Ds, Ww, Ww
Xos, Xos, Xos, Xos, Xos, Xos, Xos, Rra, Rra, Rra, Rra, Rra, Rra, Rra, Rra, Rra, Rra, Xos, Xos, Xos, Xos, Xos, Xos, Xos, Xos, Xos, Xos, Xos, Xos, Xos, Gs^Fp, Gg, Gg, Gs^Fp, Gg, Gg, Ww, Ww
Xos, Xos, Xos, Xos, Xos, Xos, Rra, Rra, Rra, Isa, Rra, Rra, Rb, Rra, Rra, Isa, Rb, Rb, Rb, Xos, Xos, Xos, Xos, Xos, Xos, Xos, Xos, Xos, Xos, Xos, Gs^Fp, Gg^Ve, Gs^Fp, Gs^Fp, Gg, Gg, Ww, Ww
Xos, Xos, Xos, Xos, Rra, Rra, Rra, Rra, Rra, Rra, Rb, Rb, Rb, Rb, Rb, Rra, Rra, Isa, Rb, Rra, Rra, Xos, Xos, Xos, Xos, Xos, Xos, Xos, Xos, Xos, Gg, Gg, Gs^Fp, Gs^Fp, Gs^Fp, Ds, Ww, Ww
Xos, Xos, Xos, Xos, Rra, Rra, Rra, Rra, Rb, Rb, Isa, Rb, Rra, Rra, Isa, Rb, Rb, Rra, Rra, Rb, Rra, Xos, Xos, Xos, Xos, Xos, Xos, Xos, Xos, Xos, Gg, Gg, Gg, Gs^Fp, Gg, Ds, Ss, Ww
Xos, Xos, Xos, Xos, Isa, Rra, Rra, Rb, Isa, Isa, Kh, Ch, Rb, Isa, Isa, Isa, Rb, Rb, Rra, Rra, Rb, Xos, Xos, Xos, Xos, Xos, Xos, Xos, Rb, Xos, Gg, Gg, Rd, Gg, Gg, Gg, Ss, Ss
Xos, Xos, Xos, Xos, Isa, Rra, Rra, Isa, Isa, Isa, Ch, Ch, Rra, Isa, Rb, Isa, Isa, Rb, Isa, Rb, Rb, Rb, Rb, Xos, Xos, Xos, Rra, Rb, Rra, Ch, Gg, Gg, Gg, Rd, Rd, Gg, Gg, Gg
Xos, Xos, Xos, Xos, Isa, Rra, Rra, Isa, Rb, Rb, Rra, Rra, Rb, Rb, Rra, Rb, Rb, Rb, Rra, Rra, Rra, Rra, Rra, Rb, Rra, Rra, Rb, Rra, Isa, Rra, Gg, Gg, Rr, Rr, Rr, Rd, 1 Gg, Gg
Rra, Rra, Rra, Rra, Isa, Rra, Rra, Rb, Rra, Rra, Rra, Rra, Rra, Rra, Rb, Rra, Rra, Rra, Rra, Rra, Rb, Rb, Isa, Rra, Rb, Rb, Xos, Xos, Xos, Ch, Gg, Gg, Gg, Gg, Gg, Rr, Rr, Gg
Xos, Xos, Xos, Xos, Rra, Isa, Rra, Rra, Rb, Rb, Isa, Isa, Isa, Rra, Rb, Rb, Rb, Rra, Rb, Rb, Rra, Xos, Xos, Rb, Xos, Xos, Xos, Xos, Xos, Xos, Gg, Gg, Gg, Gg, Gg, Gg, Gg, Rr
Xos, Xos, Xos, Xos, Rra, Rra, Rra, Rra, Isa, Isa, Rra, Rra, Rra, Rb, Isa, Isa, Isa, Rb, Isa, Rb, Rra, Xos, Xos, Xos, Xos, Xos, Xos, Xos, Xos, Xos, Gg, Gg, Gg, Gg, Re, Gg, Gg, Gg
Xos, Xos, Xos, Xos, Rra, Rb, Rra, Rb, Isa, Rra, Isa, Rra, Isa, Rb, Isa, Isa, Isa, Isa, Rra, Rra, Rra, Xos, Xos, Xos, Xos, Xos, Xos, Xos, Xos, Xos, Gg, Gg, Gg, Re, Gg^Vh, Gs^Fp, Gs^Fp, Gg
Xos, Xos, Xos, Xos, Rra, Rb, Rra, Rb, Rb, Isa, Rra, Isa, Rra, Rb, Rra, Rra, Rra, Rra, Rra, Rra, Rra, Xos, Xos, Xos, Xos, Xos, Xos, Xos, Xos, Xos, Gg, Gg, Gg, Re, Gg, Gs^Fp, Gs^Fp, Gs^Fp
Xos, Xos, Xos, Xos, Rra, Rb, Rb, Rra, Rra, Rb, Rra, Rra, Rra, Rra, Rb, Isa, Rra, Rra, Rb, Rra, Rra, Xos, Xos, Xos, Xos, Xos, Xos, Xos, Xos, Xos, Gg, Gg, Gg, Re, Gg, Gg, Gg, Gs^Fp
Xos, Xos, Xos, Xos, Xos, Rra, Rra, Rb, Rb, Rra, Rra, Rra, Rra, Rra, Rra, Rra, Rra, Rb, Rra, Rra, Xos, Xos, Xos, Xos, Xos, Xos, Xos, Xos, Xos, Xos, Gg, Gg, Gg, Re, Re, Gg, Gg, Ww
Xos, Xos, Xos, Xos, Xos, Xos, Rra, Rra, Rra, Rra, Rra, Rra, Isa, Rra, Isa, Rra, Isa, Rra, Xos, Xos, Xos, Xos, Xos, Xos, Xos, Xos, Xos, Xos, Xos, Xos, Gg, Gg^Vh, Gs^Fp, Gg, Gg, Re, Ww^Bw\, Ww
Xos, Xos, Xos, Xos, Rra, Rra, Xos, Xos, Xos, Rra, Rra, Rra, Rra, Isa, Rra, Isa, Xos, Xos, Xos, Xos, Xos, Xos, Xos, Xos, Xos, Xos, Xos, Xos, Xos, Xos, Gg, Gg, Gs^Fp, Gs^Fp, Gs^Fp, Gs^Fp, Ww, Ww
Xos, Xos, Rra, Rra, Xos, Xos, Xos, Xos, Xos, Xos, Xos, Rra, Rra, Rra, Xos, Xos, Xos, Xos, Xos, Xos, Xos, Xos, Xos, Xos, Xos, Xos, Xos, Xos, Xos, Xos, Gs^Fp, Gs^Fp, Gs^Fp, Gs^Fp, Gs^Fp, Gs^Fp, Ww, Ww
Rra, Rra, Xos, Xos, Xos, Xos, Xos, Xos, Xos, Xos, Xos, Xos, Xos, Xos, Xos, Xos, Xos, Xos, Xos, Xos, Xos, Xos, Xos, Xos, Xos, Xos, Xos, Xos, Xos, Xos, Gs^Fp, Gs^Fp, Gs^Fp, Gs^Fp, Ds, Ds, Ww, Ww
Xos, Xos, Xos, Xos, Xos, Xos, Xos, Xos, Xos, Xos, Xos, Xos, Xos, Xos, Xos, Xos, Xos, Xos, Xos, Xos, Xos, Xos, Xos, Xos, Xos, Xos, Xos, Xos, Xos, Xos, Gg, Gg, Gg, Gs^Fp, Gg, Ds, Ww, Ww
