Xos, Xos, Xos, Xos, Xos, Xos, Rr, Xu, Xu, Xu, Xu, Xu, Xu, Xu, Xu, Xu, Xu, Xu, Xu, Xu, Rr, Xu, Xos, Xos, Gg, Gg, Gg, Ww, Gg, Gg, Rr, Gg, Gg
Xos, Xos, Isa, Isa, Isa, Xos, Rr, Xu, Rr, Rr, Rr, Xu, Xu, Cud, Rr, Rr^Vhc, Rr, Xu, Xu, Xu, Xu, Rr, Rr, Xos, Gg, Gg, Gg, Ww, Gg, Gg, Rr, Gg, Gg
Xos, Xos, 1 Isa, Isa, Xos, Xos, Rr, Xu, Rr, Isa, Rr, Xu, Xu, Rr, Rr, Cud, Rr, Rr^Ebn, Rr, Xu, Xu, Xu, Rr, Xos, Gg, Gg, Gg, Ww, Ww, Gg, Rr, Gg, Gg
Xos, Xos, Xos, Rr^Pr/, Rr, Rr, Rr, Xu, Xu, Rr, Rr^Pr/, Xu, Rr, Xos, Xos, Rr, Xu, Xu, Rr^Pr\, Rr, Xu, Xu, Rr, Xos, Gg, Gg^Fet, Gg, Gg, Ww, Gg, Rr, Gg, Gg
Xos, Xos, Rr, Rr, Rr, Rr, Xu, Rr, Rr, Xu, Rr, Xu, Rr, Rr, Xu, Xu, Isa, Isa, Xu, Rr, Xu, Xu, Rr, Xos, Gg, Gg, Gg, Gg, Ww, Gg, Rr, Gg, Gg
Rr, Rr, Rr, Rr^Ebn, Xu, Xu, Isa, Xu, Xu, Rr, Rr, Rr^Ebn, Xu, Xu, Xu, Isa, Xu, Xu, Rr, Rr, Xu, Xu, Rr, Xos, Gg, Gg, Gg, Gg, Rr, Ww^Bw\, Ww, Gg, Gg
Rr, Rr, Xu, Xu, Isa, Isa, Isa, Isa, Isa, Xu, Xu, Xu, Rr, Rr, Rr^Ebn, Xu, Xu, Rr, Xu, Xu, Xu, Xu, Rr, Xos, Xos, Gg, Gg, Gg, Gg, Gg, Gg, Ww, Ww
Xu, Xu, Isa, Isa, Isa, Isa, Xu, Xu, Rr, Rr, Rr, Rr, Rr, Rr^Vhc, Rr, Rr, Xu, Xu, Xu, Xu, Xu, Xu, Xu, Rr, Rr, Xos, Uu^Ii, Gg, Gg, Gg, Gg, Gg, Gg
Xu, Xu, Xu, Isa, Xu, Xu, Rr, Rr^Ebn, Rr, Rr, Xu, Rr, Xu, Xu, Xu, Xu, Rr, Xu, Xu, Xu, Xu, Xu, Xu, Xos, Uu^Ii, Uu^Ii, Isa, Uu^Ii, Xos, Gg, Gg, Gg, Gg
Xu, Rr, Rr, Xu, Rr, Rr, Xu, Rr, Xu, Xu, Rr, Xu, Rr, Rr, Rr, Rr, Rr, Rr, Ch, Xu, Xu, Xu, Xos, Xos, Cud, Isa, Cud, Xos, Xos, Xos, Xos, Gg, Gg
Xu, Rr, Rr, Rr, Xu, Xu, Xu, Xu, Rr, Rr, Xu, Rr, Rr, Rr, Rr, Rr, Rr, Ch, Kh, Ch, Xu, Xos, Xos, Rr, Rr, Rr, Rr, Rr, Xos, Xos, Xos, Xos, Xos
Xu, Rr, Rr, Rr, Rr, Xu, Xu, Xu, Xu, Xu, Isa, Xu, Xu, Rr, Rr, Rr, Rr, Ch, Xu, Xu, Xu, Rr, Rr, Rr, Rr, Rr, Rr, Rr, Xos, Rr, Rr, Xos, Rr
Xu, Xu, Xu, Rr, Rr^Vhc, Rr, Rr^Ebn, Xu, Rr^Pr\, Isa, Xu, Isa, Rr^Pr/, Xu, Rr^Pr\, Rr, Xu, Xu, Xu, Xu, Rr, Xos, Rr^Ebn, Rr, Rr, Rr, Rr, Xos, Rr, Rr, Rr, Rr, Rr
Xu, Xu, Xu, Xu, Xu, Rr, Rr, Rr, Rr, Xu, Xu, Xu, Xu, Rr, Xu, Xu, Xu, Xu, Rr, Rr, Rr, Xos, Rr, Rr, Rr, Rr, Xos, Rr, Ch, Ch, Ch, Rr, Rr
Xu, Xu, Xu, Xu, Xu, Xu, Xu, Rr, Rr, Rr, Rr, Xu, Xu, Xu, Xu, Xu, Rr, Rr, Rr, Rr, Xos, Xos, Rr, Rr, Rr, Rr, Xos, Rr, Ch, Kh, Ch, Rr, Rr
Xu, Xu, Xu, Xu, Xu, Xu, Xu, Rr, Rr, Rr, Rr, Rr, Rr^Ebn, Xu, Rr, Rr, Rr, Rr, Xos, Xos, Rr, Xos, Rr, Rr, Rr, Rr, Xos, Rr, Rr, Ch, Rr, Rr, Rr
Xu, Xu, Xu, Xu, Xu, Xu, Xu, Xu, Rr, Rr, Rr, Rr, Rr, Xu, Rr, Rr, Xos, Xos, Rr, Rr, Rr, Xos, Rr^Vhc, Rr, Rr, Rr, Xos, Rr, Rr, Rr, Rr, Rr, Rr
Xu, Xu, Xu, Xu, Xu, Xu, Xu, Xu, Rr, Rr, Rr, Rr, Rr, Xu, Rr, Rr, Rr, Xos, Xos, Rr, Rr, Xos, Rr, Rr, Rr, Rr, Rr, Rr, Rr, Rr^Vhc, Rr, Rr, Rr
Xu, Xu, Xu, Xu, Xu, Xu, Xu, Xu, Rr, Rr, Rr, Rr, Rr, Xu, Xu, Rr, Rr, Rr, Xos, Rr, Rr^Pr/, Xos, Rr, Rr, Rr, Rr^Ebn, Rr, Xos, Xos, Rr, Rr, Rr, Rr
Xu, Xu, Xu, Xu, Xu, Xu, Rr, Rr, Rr, Cud, Rr, Cud, Rr, Rr, Rr, Xu, Xu, Rr, Xos, Rr^Pr/, Rr, Xos, Xos, Rr, Rr, Rr, Rr, Rr, Rr, Xos, Xos, Rr, Rr
Xu, Xu, Xu, Xu, Xu, Rr, Rr^Vhc, Rr, Rr, Rr, Rr, Rr, Rr, Rr, Rr, Rr, Xu, Rr^Pr/, Xos, Rr, Rr, Rr, Rr, Xos, Xos, Rr, Rr, Rr, Rr, Rr, Rr, Xos, Rr
Xu, Xu, Xu, Xu, Xu, Rr, Rr, Rr, Rr, Rr, Rr, Rr, Rr, Rr, Rr, Rr, Xu, Rr, Xos, Xos, Xos, Rr, Rr, Rr, Rr^Vhc, Xos, Rr, Rr, Rr, Rr, Rr, Xos, Rr
Xu, Xu, Xu, Xu, Xu, Rr, Rr, Rr, Rr, Rr, Rr, Rr^Vhc, Rr, Rr, Rr, Rr, Xu, Rr, Xos, Xos, Rr^Pr\, Rr, Rr, Rr, Xos, Xos, Rr, Rr, Rr, Rr, Rr, Xos, Xu
Xu, Xu, Xu, Xu, Xu, Rr, Rr, Rr, Rr^Vhc, Rr, Rr, Rr, Rr, Rr, Rr^Vhc, Rr, Xu, Rr, Rr, Rr, Rr, Rr^Pr\, Xos, Xos, Rr^Ebn, Xos, Rr, Rr, Rr, Rr, Xos, Xos, Xu
Xu, Xu, Xu, Xu, Xu, Rr, Rr, Rr, Rr, Rr, Rr, Rr, Rr, Rr, Rr, Rr, Xu, Rr, Rr, Rr, Xos, Xos, Rr, Rr, Rr, Rr, Rr, Rr, Xos, Xos, Xos, Xos, Xu
Xu, Xu, Xu, Xu, Xu, Xos, Xos, Rr, Rr, Rr, Ch, Rr, Rr, Rr, Xos, Xos, Xu, Xu, Xu, Xos, Rr, Rr, Rr, Rr, Rr, Rr, Rr, Xos, Xos, Xos, Xu, Xu, Xu
Xu, Xu, Xu, Xu, Rr, Rr, Rr, Xos, Xos, Ch, Kh, Ch, Xos, Xos, Xu, Xu, Xu, Xu, Xu, Xu, Rr, Rr, Rr, Rr, Rr, Rr, Xos, Xos, Xu, Xu, Xu, Xu, Xu
Xu, Xu, Rr, Rr, Xos, Xos, Xos, Rr, Rr, Xos, Xos, Xos, Rr, Rr, Rr, Xu, Xu, Xu, Rr, Rr, Rr, Rr, Rr, Rr^Vhc, Xos, Xos, Xu, Xu, Xu, Xu, Xu, Xu, Xu
Xu, Rr, Xos, Xos, Xos, Xos, Xos, Xos, Xos, Rr^Pr/, Xu, Xu, Xu, Rr, Rr, Xu, Rr, Rr, Rr^Ebn, Rr, Rr^Pr/, Xos, Xos, Xos, Xu, Xu, Xu, Xu, Xu, Xu, Xu, Xu, Xu
Xu, Rr, Xos, Xos, Rr, Rr, Rr, Xos, Rr, Rr, Xu, Xu, Xu, Xu, Xu, Rr, Rr, Rr, Xu, Xu, Xu, Rr, Rr, Xu, Xu, Xu, Xu, Xu, Xu, Xu, Xu, Xu, Xu
Xu, Rr, Rr, Rr^Pr\, Rr, Rr, Rr, Xos, Rr, Xu, Rr, Rr, Rr^Pr/, Xu, Xu, Xu, Xu, Xu, Xu, Xu, Xu, Xu, Rr^Pr\, Xu, Xu, Xu, Xu, Xu, Xu, Xu, Xu, Xu, Xu
Xu, Rr, Xos, Xos, Rr, Rr, Xos, Xos, Xu, Rr, Xu, Xu, Xu, Rr, Rr, Rr, Rr, Rr, Rr, Rr, Rr, Rr, Xu, Xu, Xu, Xu, Xu, Xu, Xu, Xu, Xu, Xu, Xu
Xu, Xu, Xu, Xu, Xu, Xu, Xu, Xos, Xu, Xu, Xu, Xu, Xu, Xu, Xu, Xu, Xu, Xu, Xu, Xu, Xu, Xu, Xu, Xu, Xu, Xu, Xu, Xu, Xu, Xu, Xu, Xu, Xu
