Xos, Xos, Xos, Xos, Xos, Xos, Xos, Xos, Xos, Xos, Xos, Xos, Xos, Xos, Xos, Xos, Xos, Xos, Xos, Xos, Xos, Xos, Xos, Xos, Xos, Xos, Iwr, Xos, Xos, Xos, Xos, Xos, Xos, Xos, Xos, Xos, Xos, Xos, Xos, Xos, Xos, Xos, Xos, Xos, Xos, Xos, Xos, Xos, Xos, Xos, Xos, Xos, Xos, Urb, Urb, Urb, Urb, Urb, Urb, Urb, Urb, Urb
Xos, Xos, Xos, Xos, Xos, Xos, Xos, Xos, Iwr, Iwr, Iwr, Xos, Xos, Xos, Rrc, Xos, Xos, Xos, Rrc, Xos, Rrc, Xos, Xos, Xos, Iwr, Iwr, Iwr, Iwr, Iwr, Xos, Xos, Xos, Xos, Xos, Xos, Xos, Xos, Xos, Xos, Xos, Xos, Xos, Xos, Xos, Xos, Xos, Xos, Xos, Rrc, Xos, Xos, Xos, Xos, Urb, Rr^Vhc, Ch, Urb, Urb, Ch, Kh, Rr^Vhc, Urb
Xos, Xos, Xos, Xos, Xos, Xos, Xos, Iwr, Iwr, Iwr, Iwr, Iwr, Xos, Rrc, Rrc, Rrc, Rrc, Rrc, Rrc, Ch, Rrc, Rrc, Rrc, Xos, Ur^Pw\, Iwr, Iwr, Iwr, Xos, Xos, Iwr, Iwr, Iwr, Xos, Xos, Xos, Xos, Xos, Rp, Rp, Rp, Xos, Xos, Xos, Xos, Xos, Rrc, Rrc, Rrc, Rrc, Rrc, Xos, Xos, Urb, Urb, Urb, Urb, Urb, Urb, Ch, Urb, Urb
Xos, Xos, Xos, Xos, Iwr, Iwr, Iwr, Xos, Xos, Iwr, Xos, Ur^Pw/, Rrc, Rrc, Rrc, Rrc, Rrc, Rrc, Xos, Rrc, Rrc, Rrc, Rrc, Rrc, Rrc, Xos, Xos, Xos, Iwr, Iwr, Iwr, Iwr, Xos, Xos, Xos, Xos, Cud, Rp, Xos, Rb, Rb, Ur, Rp, Xos, Rrc, Rrc, Rrc, Rrc, Rrc, Rrc, Rrc, Rrc, Xos, Ch, Ch, Urb, Urb, Ch, Urb, Urb, Kh, Ch
Xos, Xos, Xos, Iwr, Iwr, Iwr, Iwr, Iwr, Ur^Pw/, Xos, Rrc, Rrc, Rrc, Rrc, Rrc, Rrc, Xos, Xos, Xos, Xos, Xos, Rrc, Rrc, Rrc, Rrc, Rrc, Rrc, Ur^Pw\, Xos, Iwr, Xos, Xos, Gg, Gg, Gg, Xos, Xos, Xos, Xos, Xos, Xos, Ur, Rp, Xos, Rrc^Vhc, Rrc, Rrc, Rrc, Rrc, Rrc, Rrc, Rrc, Xos, Ch, Ch, Ch, Ch, Rr^Vhc, Ch, Ch, Ch, Ch
Xos, Xos, Xos, Iwr, Iwr, Iwr, Xos, Xos, Rrc, Rrc, Rrc, Rrc, Rrc, Rrc, Rrc, Xos, Iwr, Iwr, Iwr, Xos, Xos, Xos, Xos, Ch, Rrc, Rrc, Rrc, Rrc, Rrc, Xos, Gg, Gg, Gs^Fp, Gg, Gs^Fp, Gg, Gg, Xos, Xos, Xos, Xos, Ur, Rb, Xos, Rrc, Rrc, Rrc, Rrc^Vhc, Xos, Rrc, Rrc, Rrc, Xos, Urb, Urb, Ch, Ch, Ch, Ch, Ch, Xos, Xos
Xos, Xos, Xos, Xos, Xos, Xos, Iwr, Ur^Pw\, Xos, Rrc, Rrc, Rrc, Rrc, Xos, Iwr, Xos, Iwr^Z/, Xos, Iwr, Xos, Iwr, Iwr, Iwr, Xos, Xos, Rrc, Rrc, Rrc, Gg, Gg, Gg, Gg, Gg, Gg, Gg, Gg, Gg, Gg, Xos, Xos, Xos, Rb, Ur, Xos, Rrc, Rrc, Rrc, Rrc, Xos, Rrc, Rrc, Rrc, Xos, Urb, Urb, Urb, Urb, Ch, Ch, Ch, Xos, Xos
Xos, Xos, Xos, Xos, Iwr, Iwr, Xos, Xos, Rrc, Rrc, Rrc, Rrc, Xos, Xos, Iwr, Xos, Iwr, Xos, Iwr, Xos, Iwr, Xos, Xos, Iwr, Xos, Xos, Xos, Rrc, Gg, Gg, Gg, Gg, Gg^Vh, Gg, Gg, Gg^Ve, Gg, Gg, Xos, Xos, Xos, Uu, Uu, Xos, Rrc, Rrc, Rrc, Rrc, Xos, Rrc, Rrc, Rrc, Rrc, Xos, Urb, Urb, Urb, Urb, Urb, Ch, Xos, Xos
Xos, Xos, Iwr, Iwr, Iwr, Xos, Ur^Pw\, Rrc, Rrc, Rrc, Rrc, Rrc, Xos, Iwr^Z\, Xos, Xos, Iwr, Xos, Iwr^Z/, Xos, Iwr^Z\, Xos, Xos, Iwr, Iwr, Xos, Iwr, Xos, Gg, Gg, Gg, Gs^Ft, Gs^Ft, Gs^Ft, Gs^Fp, Gs^Fp, Gg, Gg, Xos, Xos, Xos, Rp, Uh, Xos, Xos, Rrc, Rrc, Rrc, Rrc, Xos, Xos, Rrc, Rrc, Xos, Xos, Urb, Urb, Urb, Urb, Urb, Xos, Xos
Xos, Xos, Iwr, Iwr, Iwr, Iwr, Iwr, Xos, Rrc, Rrc, Rrc, Rrc, Xos, Iwr, Iwr, Iwr, Xos, Xos, Xos, Iwr, Xos, Xos, Iwr, Iwr, Iwr, Iwr, Iwr, Xos, Gg, Gg^Ve, Ww, Ww, Ww, Ww, Gs^Fp, Gs^Fp, Gg, Gg, Xos, Xos, Uu, Uu^Ii, Uu^Ii, Uh^Ii, Xos, Rrc, Rrc, Rrc, Rrc, Rrc, Xos, Rrc, Rrc, Xos, Xos, Urb, Urb, Urb, Urb, Urb, Xos, Xos
Xos, Xos, Xos, Iwr, Iwr, Iwr, Xos, Xos, Rrc, Rrc, Rrc, Rrc, Rrc, Xos, Xos, Xos, Xos, Xos, Xos, Xos, Xos, Xos, Iwr, Iwr, Iwr, Iwr, Iwr, Xos, Gg, Gg, Ww, Ww, Ww, Ww, Ww, Gg, Gg, Gg, Xos, Rp, Rb, Rb, Uu^Ii, Rb, Rp, Xos, Xos, Rrc, Rrc, Rrc, Xos, Rrc, Rrc, Xos, Xos, Rr^Vhc, Urb, Urb, Urb, Urb, Xos, Xos
Xos, Xos, Xos, Xos, Xos, Xos, Xos, Xos, Ch, Rrc, Rrc, Rrc, Xos, Iwr^Pw/o, Iwr, Xos, Xos, Xos, Iwr, Iwr, Iwr, Xos, Xos, Iwr, Iwr, Iwr, Iwr, Xos, Gg, Gg, Ww, Ww, Ww, Ww, Gs^Ft, Gs^Ft, Gg^Vh, Gg, Xos, Rp, Rb, Uu, Rb, Rb, Rp, Uh, Xos, Rrc, Rrc, Rrc, Xos, Rrc, Rrc, Xos, Xos, Urb, Urb, Urb, Urb, Urb, Xos, Xos
Xos, Xos, Xos, Xos, Xos, Xos, Xos, Xos, Rrc, Rrc, Rrc, Rrc, Xos, Xos, Xos, Iwr, Iwr, Iwr, Iwr, Iwr, Iwr, Iwr, Xos, Iwr, Iwr, Iwr, Iwr, Xos, Gg, Gs^Fp, Gs^Fp, Ww, Gg, Gg, Gs^Fp, Gg, Gg, Gg, Xos, Uu^Vu, Rb, Rb, Rb, Uu^Ii, Uu^Vud, Uh^Ii, Xos, Rrc, Rrc, Rrc, Xos, Rrc, Rrc^Vhc, Xos, Xos, Urb, Urb, Urb, Urb, Rr^Vhc, Xos, Xos
Xos, Xos, Gg, Gg, Gg, Xos, Xos, Xos, Rrc, Rrc, Rrc, Ch, Xos, Xos, Xos, Xos, Iwr, Iwr, Iwr, Iwr, Iwr, Iwr, Xos, Iwr, Xos, Xos, Xos, Xos, Gg, Gs^Fp, Gs^Fp, Gs^Fp, Gg, Gg, Gg, Gg, Gg, Gg, Xos, Uu^Ii, Rb, Rb, Uu^Vu, Uu, Xos, Xos, Rrc, Rrc, Rrc, Rrc, Xos, 5 Rrc, Rrc, Xos, Xos, Urb, Urb, Urb, Urb, Urb, Xos, Xos
Gg, Gg, Gg, Gg, Gs^Fp, Gg, Gg, Gg, Gg, Rrc, Rrc, Rrc, Xos, Xos, Xos, Xos, Iwr, Iwr, Iwr, Iwr, Iwr, Iwr, Xos, Xos, Iwr, Iwr, Iwr, Xos, Xos, Gg, Gg, Gs^Fp, Gg, Gg, Gg, Gg, Gg, Gg, Xos, Rp, Uu^Vud, Rp, Xos, Xos, Rrc, Rrc, Rrc, Rrc, Rrc, Rrc, Xos, Rrc, Rrc, Xos, Xos, Urb, Urb, Urb, Urb, Urb, Xos, Xos
Gg, Gs^Ft, Gs^Fp, Gs^Fp, Gg^Ve, Gs^Fp, Gg, Gg, Rd, Gg, Gg, Rrc, Xos, Xos, Xos, Xos, Iwr, Iwr, Iwr, Iwr, Iwr, Iwr, Xos, Iwr, Iwr, Iwr, Iwr, Xos, Xos, Xos, Xos, Gg, Gg, Gg, Gg, Gg, Gg, Gg, Ch, Xos, Xos, Xos, Rrc, Rrc, Rrc, Rrc, Rrc, Rrc, Rrc, Rrc^Vhc, Xos, Rrc, Rrc, Xos, Xos, Urb, Urb, Urb, Urb, Urb, Xos, Xos
Gg, Gg, Gs^Fp, Gg, Gs^Ft, Gg, Rd, Rd, Gs^Ft, Gs^Fp, Gg, Gg, Xos, Xos, Xos, Xos, Xos, Iwr, Iwr, Iwr, Xos, Iwr, Iwr, Xos, Xos, Iwr, Iwr, Xos, Xos, Xos, Iwr, Xos, Xos, Gg, Xos, Xos, Ch, Rrc, Rrc, Rrc, Rrc, Rrc, Rrc, Rrc, Rrc, Rrc, Rrc, Rrc, Xos, Xos, Xos, Rrc, Rrc, Xos, Urb^Pw\o, Urb, Urb, Urb, Urb, Urb, Xos, Xos
Gg, Gg, Gg, Gs^Fp, Gs^Fp, Rd, Gs^Fp, Gs^Fp, Gs^Fp, Gs^Ft, Gs^Ft, Gg, Gg, Xos, Xos, Xos, Xos, Xos, Xos, Xos, Xos, Xos, Iwr, Xos, Iwr, Iwr, Xos, Xos, Iwr, Iwr, Iwr, Iwr, Iwr, Xos, Xos, Xos, Xos, Rrc, Rrc, Rrc, Rrc, Rrc, Ch, Rrc, Rrc, Rrc, Ur^Pw/, Xos, Iwr, Xos, Xos, Rrc, Rrc, Rrc, Rrc, Urb^Pw\o, Xos, Urb, Urb^Pw/, Xos, Iwr, Xos
Gg, Gg^Ve, Gg, Gg, Rd, Rd, Gs^Fp, Gs^Fp, Gs^Fp, Gg^Ve, Gs^Fp, Gg, Gg, Gg, Xos, Xos, Xos, Xos, Xos, Xos, Xos, Xos, Iwr, Xos, Xos, Iwr, Xos, Iwr, Iwr, Iwr, Iwr, Iwr, Xos, Iwr, Iwr, Iwr, Iwr, Ur^Pw\, Xos, Rrc, Ch, Ch, 8 Kh, Ch, Xos, Xos, Iwr, Iwr, Iwr, Iwr, Xos, Xos, Xos, Rrc, Xos, Xos, Xos, Xos, Iwr, Iwr, Iwr, Iwr
Gg, Ce, Ce, Gg, Gg, Gg, Gs^Fp, Gg, Gg, Gs^Fp, Gs^Fp, Gg, Gg, Gg, Xos, Xos, Xos, Xos, Xos, Xos, Xos, Xos, Iwr, Xos, Iwr, Iwr, Xos, Xos, Xos, Iwr, Xos, Xos, Xos, Iwr, Iwr, Iwr, Iwr, Iwr, Xos, Xos, Xos, Ch, Ch, Ch, Xos, Xos, Xos, Iwr, Xos, Iwr, Iwr, Xos, Iwr, Xos, Xos, Xos, Iwr, Iwr, Iwr, Iwr, Iwr, Iwr
Gg, 1 Ke, Ce, Ce, Gg, Gg, Gg, Gs^Ft, Gg, Gg, Gg, Gs^Fp, Gg, Gg^Vc, Xos, Xos, Xos, Xos, Xos, Xos, Xos, Xos, Xos, Iwr, Xos, Xos, Xos, Xos, Xos, Xos, Xos, Xos, Xos, Xos, Xos, Iwr, Xos, Xos, Xos, Xos, Xos, Xos, Xos, Xos, Xos, Xos, Xos, Xos, Xos, Xos, Iwr, Iwr, Iwr, Iwr, Iwr, Xos, Xos, Iwr, Iwr, Iwr, Iwr, Iwr
Gg, Gg, Gg, Gg, Gg, Gg, Gg, Gg, Gg, Gg, Gg, Gs^Fp, Gg, Gg, Gg, Xos, Xos, Xos, Xos, Xos, Xos, Xos, Xos, Xos, Xos, Xos, Xos, Xos, Xos, Xos, Xos, Xos, Xos, Xos, Xos, Xos, Xos, Xos, Xos, Xos, Xos, Xos, Xos, Xos, Xos, Xos, Xos, Xos, Xos, Xos, Xos, Iwr, Iwr, Iwr, Xos, Xos, Xos, Xos, Xos, Iwr, Iwr, Iwr
