Uh, Uh, Uh, Rd, Uu, Uu, Uu, Xu, Xos, Xos, Xos, Xos, Xu, Xu, Xu, Xu, Xu, Xu, Xu, Xu, Xu, Xu, Xu, Xu, Xu, Xu, Xu, Xu, Xu, Xu, Xu, Xu, Xu, Xu, Xu, Xu, Xu, Xu, Xu, Xu, Rr, Rr, Rr, Rr, Cud, Cud
Uh, Uh, Sm, Rd, Rd, Uu, Uu^Vud, Uh, Xos, Xos, Xos, Xu, Xu, Xu, Sm, Wwg, Sm, Uu, Rr, Xu, Sm^Bw/, Sm^Bw/, Sm, Sm, Sm^Bw/, Xu, Sm^Bw\, Xu, Sm^Bw/, Sm, Sm^Vhs, Xu, Xu, Xu, Xu, Xu, Xu, Xu, Xu, Xu, Uu^Vud, Rr, Rr, Cud, Kud, Cud
Sm, Sm, Ce, Ce, Ce, Re, Re, Uh, Xos, Xos, Xos, Xu, Uu, Sm^Vhs, Re, Re, Uu, Rr, Re, Sm, Uu^Tf, Xu, Xu, Sm, Xu, Sm, Xu, Sm^Bw\, Xu, Sm, Xu, Xu, Xu, Xu, Xu, Xu, Xu, Xu, Xu, Xu, Rr^Ebn, Rr, Rr, Cud, Cud, Cud
Sm, Sm, Ce, 1 Ke, Ce, Rr, Re, Uh, Xos, Xos, Xu, Xu, Uu, Rd, Sm, Uu, Xu, Uu, Uu, Sm, Rr, Uu^Vu, Rr^Z/, Xu, Xu, Xu, Xu, Xu, Xu, Xu, Xu, Xu, Xu, Xu, Xu, Xu, Xu, Xu, Rr, Rr, Rr, Rr, Uu^Vud, Rr, Rr, Rr
Sm, Sm, Uu^Vu, Ce, Sm, Sm, Rd, Xos, Xos, Xos, Xu, Uu, Rr, Rr, Sm, Xu, Xu, Xu, Xu, Rr, Rr^Z/, Rr^Z/, Rr, Xos, Xos, Xos, Xos, Xu, Xu, Xu, Xu, Xu, Xu, Xu, Xu, Xu, Xu, Rr, Xu, Xu, Rr, Rr, Rr, Rr, Uu^Vud, Rr
Xos, Uu, Xos, Uu, Xos, Rr, Rr, Rr, Uu, Xu, Xu, Uu^Tf, Rr, Sm, Re, Xu, Xu, Xu, Xos, Xos, Rr, Rr, Rr, Rr, Rr, Rr, Rr, Xos, Xos, Xu, Xu, Xu, Xu, Xu, Xu, Xu, Xu, Rr, Xu, Xu, Rr, Rr, Rr, Rr, Rr, Rr
Xos, Xos, Xos, Xos, Xos, Xos, Xos, Sm^Vhs, Uh, Xu, Xu, Uu, Rr, Sm, Re, Xu, Xu, Xos, Rr, Rr, Rr, Rr, Rr, Rr, Rr, Rr, Rr, Xos, Xos, Xu, Xu, Xu, Xu, Xu, Xu, Xu, Xu, Rr, Rr, Rr, Xu, Xu, Rr, Xu, Xu, Xu
Sm, Wwg, Wwg, Wwg, Wwg, Sm, Sm, Sm^Bw|, Rd, Xu, Xu, Xu, Uu, Rd, Re, Xu, Xu, Xos, Rr, Rr, Rr, Rr, Rr, Rr, Rr, Rr, Rr, Rr, Xos, Xu, Rr^Ebn, Xu, Xu, Xu, Xu, Xu, Xu, Xu, Xu, Rr, Rr, Rr, Rr, Rr, Xu, Xu
Sm, Sm, Sm, Sm, Sm, Sm, Xu, Sm^Bw|, Rd, Xu, Xu, Xu, Uu, Rd, Uu, Xu, Xos, Xos, Rr, Rr, Rr, Rr, Rr, Rr, Rr, Rr, Rr, Rr, Xos, Rr, Rr, Rr, Rr, Xu, Xu, Xu, Xu, Xu, Xu, Xu, Xu, Rr, Rr, Rr^Ebn, Uu^Vud, Xu
Sm, Sm, Xu, Xu, Xu, Xu, Xu, Sm, Xu, Xu, Rr, Uu, Sm, Rd, Uu, Xu, Xos, Rr, Rr, Rr, Rr, Rr, Rr, Rr, Rr, Rr, Rr, Rr, Xos, Rr, Rr, Rr, Rr, Rr, Uu^Vud, Xu, Xu, Xu, Xu, Xu, Xu, Rr, Rr, Rr, Rr, Xu
Xu, Xu, Xu, Xu, Xu, Xu, Uu^Tf, Sm, Rr, Xu, Rr, Sm, Sm, Rd, Xu, Xu, Xu, Rr, Rr, Rr, Rr, Rr, Rr, Rr, Rr, Rr, Rr, Rr, Xos, Xu, Xu, Rr, Rr, Rr, Rr, Xu, Xu, Xu, Xu, Xu, Rr, Rr, Rr, Rr, Xu, Xu
Xu, Xu, Xu, Xu, Uu^Vu, Uu, Rd, Rr, Rr, Rr, Uu, Uu, Xu, Sm, Xu, Sm, Uu^Tf, Xu, Rr, Rr, Rr, Rr, Rr, Rr, Rr, Rr, Rr, Rr, Xos, Xu, Xu, Xu, Xu, Rr, Rr, Xu, Xu, Xu, Xu, Xu, Rr, Rr, Rr, Rr, Xu, Xu
Xu, Xu, Xu, Xu, Uh, Uu^Tf, Rd, Sm, Xu, Uu, Xu, Xu, Uu^Tf, Xu, Xu, Sm, Re, Xu, Xu, Rr, Rr, Rr, Rr, Rr, Rr, Rr, Rr, Xos, Xu, Xu, Xu, Xu, Xu, Rr^Ebn, Rr, Xu, Xu, Xu, Rr^Ebn, Rr, Rr, Rr, Rr, Xu, Xu, Xu
Xu, Xu, Xu, Xu, Uh, Sm, Wwg, Xu, Xu, Xu, Re, Re, Re, Uh, Xu, Xu, Re, Xu, Xu, Rr, Rr, Rr, Rr, Rr, Rr, Rr, Xos, Xos, Xu, Xu, Xu, Xu, Xu, Rr, Rr, Rr, Rr, Xu, Rr, Rr, Rr, Rr, Xu, Xu, Xu, Xu
Xu, Xu, Xu, Xu, Rr, Sm, Rr, Xu, Xu, Re, Xu, Uu^Tf, Xu, Xu, Uu, Re, Xu, Xu, Uu, Rr^Z\, Rr^Z\, Rr, Xos, Xos, Xos, Xos, Xu, Xu, Xu, Xu, Xu, Xu, Xu, Xu, Xu, Rr, Rr, Rr, Rr, Rr, Rr, Xu, Xu, Xu, Xu, Xu
Xu, Xu, Xu, Xu, Rr, Rd, Rr, Rr, Xu, Uu, Xu, Xu, Sm, Uu, Xu, Xu, Sm, Uh, Rd, Rd, Xu, Xos, Xu, Xu, Xu, Xu, Xu, Xu, Xu, Xu, Xu, Xu, Xu, Xu, Xu, Xu, Rr, Xu, Xu, Xu, Rr, Xu, Xu, Xu, Xu, Xu
Xu, Xu, Xu, Xu, Uu, Rd, Re, Rr, Xu, Re, Re, Sm, Xu, Xu, Sm, Sm, Wwg, Rd, Sm, Xu, Sm, Xu, Xu, Xu, Xu, Xu, Xu, Xu, Xu, Xu, Xu, Xu, Xu, Xu, Xu, Xu, Xu, Rr, Uu^Vud, Rr, Xu, Xu, Xu, Xu, Xu, Xu
Xu, Xu, Xu, Xu, Xu, Uu, Re, Rr, Xu, Xu, Xu, Xu, Xu, Xu, Sm, Wwg, Sm, Wwg, Sm, Sm^Bw\, Sm^Bw\, Sm, Sm, Xu, Xu, Xu, Xu, Xu, Xu, Xu, Xu, Xu, Xu, Xu, Xu, Xu, Xu, Xu, Xu, Xu, Xu, Xu, Xu, Xu, Xu, Xu
Xu, Xu, Xu, Xu, Xu, Sm, Re, Rr, Rr, Xu, Rr, Uu^Tf, Uu, Uh, Sm^Bw/, Sm^Bw/, Uu, Sm, Xu, Xu, Sm, Sm^Bw\, Sm^Bw\, Sm, Sm, Sm, Sm, Sm, Sm, Sm, Xu, Xu, Xu, Xu, Xu, Xu, Xu, Xu, Xu, Xu, Xu, Xu, Xu, Xu, Xu, Xu
Xu, Xu, Xu, Xu, Xu, Sm, Sm, Rr, Rr, Rr, Rd, Rr, Re, Rd, Uh, Uu, Xu, Xu, Xu, Xu, Xu, Xu, Xu, Sm, Xu, Sm, Sm^Bw/, Sm^Bw/, Sm, Sm^Vhs, Xu, Xu, Xu, Xu, Xu, Xu, Xu, Xu, Xu, Xu, Xu, Xu, Xu, Xu, Xu, Xu
Xu, Xu, Xu, Xu, Xu, Uu, Sm, Sm, Sm, Rd, Uu^Vu, Re, Uu, Uh, Xu, Xu, Xu, Xu, Xu, Xu, Xu, Xu, Xu, Xu, Xu, Xu, Xu, Xu, Xu, Xu, Xu, Xu, Xu, Xu, Xu, Xu, Xu, Xu, Xu, Xu, Xu, Xu, Xu, Xu, Xu, Xu
Xu, Xu, Xu, Xu, Xu, Xu, Xu, Wwg, Wwg, Sm, Uu, Uu^Tf, Xu, Xu, Xu, Xu, Xu, Xu, Xu, Xu, Xu, Xu, Xu, Xu, Xu, Xu, Xu, Xu, Xu, Xu, Xu, Xu, Xu, Xu, Xu, Xu, Xu, Xu, Xu, Xu, Xu, Xu, Xu, Xu, Xu, Xu
Xu, Xu, Xu, Xu, Xu, Xu, Xu, Xu, Xu, Xu, Xu, Xu, Xu, Xu, Xu, Xu, Xu, Xu, Xu, Xu, Xu, Xu, Xu, Xu, Xu, Xu, Xu, Xu, Xu, Xu, Xu, Xu, Xu, Xu, Xu, Xu, Xu, Xu, Xu, Xu, Xu, Xu, Xu, Xu, Xu, Xu
Xu, Xu, Xu, Xu, Xu, Xu, Xu, Xu, Xu, Xu, Xu, Xu, Xu, Xu, Xu, Xu, Xu, Xu, Xu, Xu, Xu, Xu, Xu, Xu, Xu, Xu, Xu, Xu, Xu, Xu, Qlf, Xu, Qlf, Xu, Ql, Qlf, Ql, Ql, Ql, Ql, Ql, Xu, Ql, Xu, Xu, Xu
Xu, Xu, Xu, Xu, Xu, Xu, Xu, Xu, Ds, Xu, Ds, Xu, Xu, Xu, Xu, Xu, Xu, Xu, Xu, Xu, Xu, Xu, Xu, Xu, Xu, Xu, Xu, Xu, Qlf, Qlf, Cud, Qlf, Ql, Ql, Rp, Ql, Rp, Rp, Rp, Rp, Rp, Ql, Rp, Ql, Ql, Xu
Xu, Xu, Xu, Xu, Xu, Xu, Ds, Ds, Ds, Ds, Wwf, Xu, Xu, Xu, Xu, Xu, Dd^Vdt, Xu, Xu, Xu, Xu, Xu, Xu, Xu, Xu, Xu, Xu, Qlf, Ql, Rp, Rp, Rp, Ql, Rp, Rp, Rp, Rp, Rp, Rp, Rp, Uu^Vud, Cud, Cud, Rp, Rp, Ql
Xu, Xu, Xu, Xu, Xu, Xu, Xu, Ww, Wwf, Wwf, Ww, Chw, Ww, Ww, Ww, Ds, Ww, Ds, Xu, Xu, Xu, Xu, Xu, Xu, Xu, Qlf, Qlf, Qlf, Ql, Rp, Uu^Vud, Ql, Rp, Rp, Rp, Rp, Rp, Rp, Rp, Rp, Cud, Kud, Uu^Vud, Rp, Rp, Rp
Xu, Xu, Xu, Xu, Xu, Xu, Ww, Ww, Ww, Ww, Ww, Ww, Ww, Wo, Chw, Ww, Wwf, Ds, Ds, Xu, Xu, Xu, Xu, Xu, Qlf, Qlf, Ql, Ql, Rp, Rp, Ql, Ql, Rp, Rp, Rp, Rp, Ql, Rp, Rp, Rp, Rp, Cud, Ql, Rp, Rp, Rp
Xu, Xu, Xu, Xu, Xu, Xu, Wwf, Wwf, Wwf, Wwf, Ww, Wwf, Wwf, Wwf, Wwf, Wwf, Ww, Wwf, Wwf, Xu, Xu, Xu, Xu, Xu, Qlf, Ql, Rp, Rp, Ql, Ql, Rp, Ql, Ql, Rp, Ql^Bs\, Ql^Bs\, Rp, Ql, Ql, Ql, Ql, Ql, Rp, Ql, Ql, Rp
Xu, Xu, Xu, Xu, Xu, Xu, Wwf, Wwf, Wwf, Ww, Xu, Xu, Xu, Wwf, Ww, Ww, Ww, Ww, Xu, Xu, Xu, Xu, Xu, Xu, Qlf, Ql, Rp, Ql, Rp, Rp, Rp, Rp, Rp, Ql, Ql, Rp, Rp, Rp, Rp, Rp, Rp, Rp, Rp, Rp, Rp, Ql
Xu, Xu, Xu, Xu, Ds, Ds, Wwf, Wo, Ww, Ww, Xu, Xu, Xu, Ww, Wwf, Ww, Ww^Vm, Wwf, Wwf, Xu, Xu, Xu, Xu, Qlf, Ql, Ql, Rp, Ql, Rp, Rp, Rp, Rp, Rp, Rp, Rp, Ql, Ql, Rp, Rp, Rp, Rp, Rp, Rp, Rp, Rp, Rp
Xu, Xu, Ds, Xu, Ww, Ww, Ww, Chw, Ww, Ww^Vm, Ds, Xu, Xu, Xu, Wwf, Ww, Wwf, Wwf, Ds, Xu, Xu, Xu, Xu, Qlf, Ql, Ql, Rp, Rp, Rp, Rp, Rp, Rp, Rp, Rp, Rp, Rp, Rp, Uu^Vud, Rp, Rp, Rp, Rp, Rp, Rp, Rp, Rp
Xu, Ds, Wwf, Ww, Ww^Vm, Ww, Wwf, Wwf, Wwf, Ww, Ds, Xu, Xu, Xu, Ww, Ww, Ww, Wwf, Ds, Ds, Xu, Xu, Xu, Qlf, Ql, Rp, Rp, Rp, Rp, Rp, Rp, Rp, Ql, Uu^Vud, Ql, Rp, Rp, Rp, Rp, Rp, Rp, Rp, Rp, Rp, Rp, Rp
Ww, Ww, Wwf, Ww, Wwf, Ww, Wwf, Wwf, Xu, Xu, Xu, Xu, Xu, Ww, Ww, Wwf, Wo, Ww, Ds, Xu, Xu, Xu, Xu, Qlf, Qlf, Cud, Cud, Rp, Ql, Rp, Ql, Ql, Ql, Ql, Ql, Ql, Rp, Rp, Rp, Rp, Rp, Rp, Rp, Rp, Rp, Rp
Wwf, Khw, Ww, Wo, Ww, Wwf, Xu, Xu, Xu, Xu, Ds, Xu, Ww, Ww^Vm, Wwf, Wwf, Wwf, Wwf, Xu, Xu, Xu, Xu, Xu, Xu, Qlf, Kud, Qlf, Qlf, Qlf, Qlf, Ql, Xu, Ql, Ql, Xu, Ql, Ql, Rp, Rp, Rp, Rp, Rp, Rp, Rp, Uu^Vud, Rp
Wwf, Wwf, Ww, Ww, Ds, Xu, Xu, Xu, Xu, Ds, Wwf, Wwf, Wwf, Wwf, Chw, Ww, Ww, Ww, Xu, Xu, Xu, Xu, Xu, Xu, Xu, Qlf, Xu, Xu, Xu, Xu, Xu, Ql, Ql, Ql, Ql, Ql, Qlf, Ql, Ql, Ql, Ql, Ql, Ql, Ql, Ql, Ql
Ww, Ww, Xu, Ds, Xu, Xu, Xu, Xu, Ww, Ww, Wwf, Ww, Wo, Chw, Khw, Wwf, Ww, Ww, Xu, Xu, Xu, Xu, Xu, Xu, Xu, Xu, Xu, Xu, Xu, Xu, Xu, Xu, Xu, Xu, Xu, Qlf, Xu, Qlf, Xu, Xu, Xu, Xu, Xu, Ql, Xu, Ql
Xu, Xu, Xu, Xu, Xu, Xu, Xu, Xu, Wwf, Wwf, Wwf, Ww, Ww, Ww, Wwf, Wwf, Xu, Ww, Xu, Xu, Xu, Xu, Xu, Xu, Xu, Xu, Xu, Xu, Xu, Xu, Xu, Xu, Xu, Xu, Xu, Xu, Xu, Xu, Xu, Xu, Xu, Xu, Xu, Xu, Xu, Xu
Xu, Xu, Xu, Xu, Xu, Xu, Xu, Xu, Wwf, Cv, Wwf, Wwf, Ww, Wwf, Wwf, Wwf, Xu, Xu, Xu, Xu, Xu, Xu, Xu, Xu, Xu, Xu, Xu, Xu, Xu, Xu, Xu, Xu, Xu, Xu, Xu, Xu, Xu, Xu, Xu, Xu, Xu, Xu, Xu, Xu, Xu, Xu
Xu, Xu, Xu, Xu, Xu, Xu, Xu, Xu, Xu, Wwf, Wwf, Ww^Vm, Xu, Ds, Ds, Ds, Xu, Xu, Xu, Xu, Xu, Xu, Xu, Xu, Xu, Xu, Xu, Xu, Xu, Xu, Xu, Xu, Xu, Xu, Xu, Xu, Xu, Xu, Xu, Xu, Xu, Xu, Xu, Xu, Xu, Xu
Xu, Xu, Xu, Xu, Xu, Xu, Xu, Xu, Xu, Xu, Xu, Xu, Xu, Xu, Xu, Xu, Xu, Xu, Xu, Xu, Xu, Xu, Xu, Xu, Xu, Xu, Xu, Xu, Xu, Xu, Gs, Xu, Xu, Xu, Ds, Xu, Hd, Xu, Hd, Xu, Ds, Xu, Ds, Xu, Ds, Xu
Dd, Xu, Dd, Xu, Xu, Xu, Xu, Xu, Mdd^Xm, Xu, Mdd^Xm, Xu, Xu, Xu, Hd, Xu, Hd, Xu, Xu, Xu, Ds, Xu, Ds, Xu, Rd, Dd, Rd, Dd, Dd, Dd, Dd, Gs, Gs, Ds, Ds, Hd, Hd, Hd, Hd, Hd, Hd, Hd, Dd^Vda, Rb^Dr, Ds, Ds
Dd, Dd, Ds, Dd, Dd, Ds, Dd, Ds, Ds, Mdd^Xm, Mdd, Mdd^Xm, Ds, Hd, Dd, Hd, Hd, Dd, Hd, Ds, Ds, Ds, Dd^Vdt, Rd, Rd, Rd, Dd, Rd, Rd, Dd, Dd, Dd, Dd, Dd, Dd, Dd, Dd, Hd, Hd, Dd, Dd, Hd, Dd, Ds, Gs, Ds
Rd, Dd, Dd, Dd, Ds, Dd, Ds, Dd, Dd, Dd, Mdd, Mdd, Dd, Dd^Vdt, Dd, Dd, Dd, Hd, Dd, Hd, Dd, Dd^Dc, Rd, Rd, Ds, Ds, Rb^Dr, Dd^Dc, Dd, Rd, Rd, Ds, Ds, Dd^Dc, Rb^Dr, Ds, Dd^Dc, Dd, Dd, Hd, Dd, Dd, Gs, Gs, Gs, Gs
Ds, Ce, Dd, Ds, Ds, Rb^Dr, Ds, Dd, Ds, Dd, Dd, Dd, Ds, Dd, Dd^Dc, Rb^Dr, Ds, Ds, Dd, Ds, Dd, Dd, Hd, Ds, Hd, Ds, Dd, Dd, Ds, Dd, Dd, Dd^Dc, Dd, Ds, Ds, Ds, Dd, Dd, Dd, Dd, Dd, Dd, Gs, Gs, Gs, Gs
Ds, Dd^Vda, Dd, Dd, Rd, Ds, Rd, Dd, Rd, Dd, Dd, Dd, Hd, Ds, Dd, Ds, Dd, Ds, Dd, Dd, Dd, Dd, Dd, Hd, Hd, Ds, Dd, Dd, Dd, Dd, Dd, Ds, Ds, Dd, Dd, Dd, Ds, Dd, Ds, Dd, Rd, Rd, Rd, Rb^Dr, Ds, Ds
Ds, Ds, Dd, Dd, Dd, Rd, Ds, Rd, Dd, Dd, Dd, Hd, Hd, Dd, Ds, Dd, Dd, Rd, Dd, Dd, Dd, Dd, Dd, Dd, Dd, Dd, Dd, Dd, Dd, Ds, Dd, Dd, Dd, Rd, Rd, Rd, Rd, Rd, Rd, Rd, Dd, Ds, Ds, Ke, Rd, Ds
Ds, Ds, Dd, Dd, Ds, Dd, Dd, Ds, Dd, Rb^Dr, Dd, Hd, Rd, Hd, Hd, Rb^Dr, Ds, Rd, Dd, Dd, Dd, Dd, Dd, Ds, Rb^Dr, Ds, Hd, Dd, Ds, Ds, Ds, Dd, Ds, Dd, Dd, Ds, Dd, Dd, Dd, Dd^Dc, Ds, Ds, Dd, Ds, Ds, Ds
Ds, Ds, Hd, Hd, Hd, Ds, Dd, Dd, Dd, Ds, Ds, Hd, Hd, Rd, Rd, Dd^Dc, Rd, Rd, Ww, Dd, Mdd, Ww, Ww, Gs, Gs, Dd, Hd, Ds, Dd^Dc, Dd^Vda, Dd, Rb^Dr, Ds, Ds, Dd, Ds, Dd, Ds, Rb^Dr, Dd, Dd, Dd, Dd, Dd, Ds, Ds
Ds, Hd, Ds, Dd, Dd, Hd, Hd, Dd, Hd, Dd, Dd, Dd, Dd, Hd, Gs, Rd, Ds, Ww, Mdd, Mdd, Mdd, Mdd, Mdd, Ww, Ww, Hhd, Hd, Hd, Hd, Dd, Dd, Dd, Dd, Dd, Dd, Dd, Ds, Ds, Ds, Ds, Gs, Dd, Gs, Dd, Ds, Ds
Ds, Ds, Ds, Ds, Ds, Ds, Ds, Hd, Hd, Ds, Ds, Dd, Ds, Gs, Ww, Ww, Hd, Mdd, Mdd, Mdd, Mdd, Mdd, Gs, Gs, Gs, Ww, Hd, Hd, Hd, Hd, Hd, Hd, Ds, Ds, Ds, Ds, Ds, Ds, Ds, Ds, Ds, Gs, Gs, Gs, Ds, Ds
