Uh, Uh, Uh, Rd, Uu, Uu, Uu, Xu, Xoa, Xoa, Xoa, Xoa, Xu, Xu, Xu, Xu, Xu, Xu, Xu, Xu, Xu, Xu, Xu, Xu, Xu, Xu, Xu, Xu, Xu, Xu, Xu, Xu, Xu, Xu, Xu, Xu, Xu, Xu, Xu, Xu, Rp, Rp, Rp, Rp, Cud, Cud
Uh, Uh, Sm, Rd, Rd, Uu, Uu^Vud, Uh, Xoa, Xoa, Xoa, Xu, Xu, Xu, Sm, Wwg, Sm, Uu, Ur, Xu, Sm^Bw/, Sm^Bw/, Sm, Sm, Sm^Bw/, Xu, Sm^Bw\, Xu, Sm^Bw/, Sm, Sm^Vhs, Xu, Xu, Xu, Xu, Xu, Xu, Xu, Xu, Xu, Uu^Vud, Rp, Rp, Cud, Kud, Cud
Sm, Sm, Ce, Ce, Ce, Ur, Re, Uh, Xoa, Xoa, Xoa, Xu, Uu, Sm^Vhs, Re, Re, Uu, Ur, Re, Sm, Uu^Tf, Xu, Xu, Sm, Xu, Sm, Xu, Sm^Bw\, Xu, Sm, Xu, Xu, Xu, Xu, Xu, Xu, Xu, Xu, Xu, Xu, Rp^Ebn, Rp, Rp, Cud, Cud, Cud
Sm, Sm, Ce, 1 Ke, Ce, Ur, Re, Uh, Xoa, Xoa, Xu, Xu, Uu, Rd, Sm, Uu, Xu, Uu, Uu, Sm, Ur, Uu^Vu, Ur^Pr/, Xu, Xu, Xu, Xu, Xu, Xu, Xu, Xu, Xu, Xu, Xu, Xu, Xu, Xu, Xu, Rp, Rp, Rp, Rp, Uu^Vud, Rp, Rp, Rp
Sm, Sm, Uu^Vu, Ce, Sm, Sm, Re, Xoa, Xoa, Xoa, Xu, Uu, Ur, Ur, Sm, Xu, Xu, Xu, Xu, Ur, Ur^Pr/, Ur^Pr/, Rr, Xoa, Xoa, Xoa, Xoa, Xu, Xu, Xu, Xu, Xu, Xu, Xu, Xu, Xu, Xu, Rp, Xu, Xu, Rp, Rp, Rp, Rp, Uu^Vud, Rp
Xoa, Uu, Xoa, Uu, Xoa, Ur, Ur, Ur, Uu, Xu, Xu, Uu^Tf, Ur, Sm, Re, Xu, Xu, Xu, Xoa, Xoa, Rr, Rr, Rr, Rr, Rr, Rr, Rr, Xoa, Xoa, Xu, Xu, Xu, Xu, Xu, Xu, Xu, Xu, Rp, Xu, Xu, Rp, Rp, Rp, Rp, Rp, Rp
Xoa, Xoa, Xoa, Xoa, Xoa, Xoa, Xoa, Sm^Vhs, Uh, Xu, Xu, Uu, Ur, Sm, Re, Xu, Xu, Xoa, Rr, Rr, Rr, Rr, Rr, Rr, Rr, Rr, Rr, Xoa, Xoa, Xu, Xu, Xu, Xu, Xu, Xu, Xu, Xu, Rp, Rp, Rp, Xu, Xu, Rp, Xu, Xu, Xu
Sm, Wwg, Wwg, Wwg, Wwg, Sm, Sm, Sm^Bw|, Rd, Xu, Xu, Xu, Uu, Rd, Re, Xu, Xu, Xoa, Rr, Rr, Rr, Rr, Rr, Rr, Rr, Rr, Rr, Rr, Xoa, Xu, Rp^Ebn, Xu, Xu, Xu, Xu, Xu, Xu, Xu, Xu, Rp, Rp, Rp, Rp, Rp, Xu, Xu
Sm, Sm, Sm, Sm, Sm, Sm, Xu, Sm^Bw|, Rd, Xu, Xu, Xu, Uu, Rd, Uu, Xu, Xoa, Xoa, Rr, Rr, Rr, Rr, Rr, Rr, Rr, Rr, Rr, Rr, Xoa, Rp, Rp, Rp, Rp, Xu, Xu, Xu, Xu, Xu, Xu, Xu, Xu, Rp, Rp, Rp^Ebn, Uu^Vud, Xu
Sm, Sm, Xu, Xu, Xu, Xu, Xu, Sm, Xu, Xu, Ur, Uu, Sm, Rd, Uu, Xu, Xoa, Rr, Rr, Rr, Rr, Rr, Rr, Rr, Rr, Rr, Rr, Rr, Xoa, Rp, Rp, Rp, Rp, Rp, Uu^Vud, Xu, Xu, Xu, Xu, Xu, Xu, Rp, Rp, Rp, Rp, Xu
Xu, Xu, Xu, Xu, Xu, Xu, Uu^Tf, Sm, Ur, Xu, Ur, Sm, Sm, Rd, Xu, Xu, Xu, Rr, Rr, Rr, Rr, Rr, Rr, Rr, Rr, Rr, Rr, Rr, Xoa, Xu, Xu, Rp, Rp, Rp, Rp, Xu, Xu, Xu, Xu, Xu, Rp, Rp, Rp, Rp, Xu, Xu
Xu, Xu, Xu, Xu, Uu^Vu, Uu, Rd, Ur, Ur, Ur, Uu, Uu, Xu, Sm, Xu, Sm, Uu^Tf, Xu, Rr, Rr, Rr, Rr, Rr, Rr, Rr, Rr, Rr, Rr, Xoa, Xu, Xu, Xu, Xu, Rp, Rp, Xu, Xu, Xu, Xu, Xu, Rp, Rp, Rp, Rp, Xu, Xu
Xu, Xu, Xu, Xu, Uh, Uu^Tf, Rd, Sm, Xu, Uu, Xu, Xu, Uu^Tf, Xu, Xu, Sm, Re, Xu, Xu, Rr, Rr, Rr, Rr, Rr, Rr, Rr, Rr, Xoa, Xu, Xu, Xu, Xu, Xu, Rp^Ebn, Rp, Xu, Xu, Xu, Rp^Ebn, Rp, Rp, Rp, Rp, Xu, Xu, Xu
Xu, Xu, Xu, Xu, Uh, Sm, Wwg, Xu, Xu, Xu, Re, Re, Re, Uh, Xu, Xu, Re, Xu, Xu, Rr, Rr, Rr, Rr, Rr, Rr, Rr, Xoa, Xoa, Xu, Xu, Xu, Xu, Xu, Rp, Rp, Rp, Rp, Xu, Rp, Rp, Rp, Rp, Xu, Xu, Xu, Xu
Xu, Xu, Xu, Xu, Ur, Sm, Ur, Xu, Xu, Re, Xu, Uu^Tf, Xu, Xu, Uu, Re, Xu, Xu, Uu, Ur^Pr\, Ur^Pr\, Rr, Xoa, Xoa, Xoa, Xoa, Xu, Xu, Xu, Xu, Xu, Xu, Xu, Xu, Xu, Rp, Rp, Rp, Rp, Rp, Rp, Xu, Xu, Xu, Xu, Xu
Xu, Xu, Xu, Xu, Ur, Rd, Ur, Ur, Xu, Uu, Xu, Xu, Sm, Uu, Xu, Xu, Sm, Uh, Rd, Rd, Xu, Xoa, Xu, Xu, Xu, Xu, Xu, Xu, Xu, Xu, Xu, Xu, Xu, Xu, Xu, Xu, Rp, Xu, Xu, Xu, Rp, Xu, Xu, Xu, Xu, Xu
Xu, Xu, Xu, Xu, Uu, Rd, Re, Ur, Xu, Re, Re, Sm, Xu, Xu, Sm, Sm, Wwg, Rd, Sm, Xu, Sm, Xu, Xu, Xu, Xu, Xu, Xu, Xu, Xu, Xu, Xu, Xu, Xu, Xu, Xu, Xu, Xu, Rp, Uu^Vud, Rp, Xu, Xu, Xu, Xu, Xu, Xu
Xu, Xu, Xu, Xu, Xu, Uu, Re, Ur, Xu, Xu, Xu, Xu, Xu, Xu, Sm, Wwg, Sm, Wwg, Sm, Sm^Bw\, Sm^Bw\, Sm, Sm, Xu, Xu, Xu, Sm, Xu, Xu, Xu, Xu, Xu, Xu, Xu, Xu, Xu, Xu, Xu, Xu, Xu, Xu, Xu, Xu, Xu, Xu, Xu
Xu, Xu, Xu, Xu, Xu, Sm, Re, Ur, Ur, Xu, Ur, Uu^Tf, Uu, Uh, Sm^Bw/, Sm^Bw/, Uu, Sm, Xu, Xu, Sm, Sm^Bw\, Sm^Bw\, Sm, Sm, Sm, Sm, Sm, Sm, Sm, Sm, Xu, Xu, Xu, Xu, Xu, Xu, Xu, Xu, Xu, Xu, Xu, Xu, Xu, Xu, Xu
Xu, Xu, Xu, Xu, Xu, Sm, Sm, Ur, Ur, Ur, Rd, Ur, Re, Rd, Uh, Uu, Xu, Xu, Xu, Xu, Xu, Xu, Xu, Sm, Xu, Sm, Sm^Bw/, Sm^Bw/, Sm, Sm^Vhs, Sm, Xu, Xu, Xu, Xu, Xu, Xu, Xu, Xu, Xu, Xu, Xu, Xu, Xu, Xu, Xu
Xu, Xu, Xu, Xu, Xu, Uu, Sm, Sm, Sm, Rd, Uu^Vu, Re, Uu, Uh, Xu, Xu, Xu, Xu, Xu, Xu, Xu, Xu, Xu, Xu, Xu, Xu, Xu, Xu, Xu, Sm, Xu, Xu, Xu, Xu, Xu, Xu, Xu, Xu, Xu, Xu, Xu, Xu, Xu, Xu, Xu, Xu
Xu, Xu, Xu, Xu, Xu, Xu, Xu, Wwg, Wwg, Sm, Uu, Uu^Tf, Xu, Xu, Xu, Xu, Xu, Xu, Xu, Xu, Xu, Xu, Xu, Xu, Xu, Xu, Xu, Xu, Xu, Xu, Xu, Xu, Xu, Xu, Xu, Xu, Xu, Xu, Xu, Xu, Xu, Xu, Xu, Xu, Xu, Xu
Xu, Xu, Xu, Xu, Xu, Xu, Xu, Xu, Xu, Xu, Xu, Xu, Xu, Xu, Xu, Xu, Xu, Xu, Xu, Xu, Xu, Xu, Xu, Xu, Xu, Xu, Xu, Xu, Xu, Xu, Xu, Xu, Xu, Xu, Xu, Xu, Xu, Xu, Xu, Xu, Xu, Xu, Xu, Xu, Xu, Xu
Xu, Xu, Xu, Xu, Xu, Xu, Xu, Xu, Xu, Xu, Xu, Xu, Xu, Xu, Xu, Xu, Xu, Xu, Xu, Xu, Xu, Xu, Xu, Xu, Xu, Xu, Xu, Xu, Xu, Xu, Qlf, Xu, Qlf, Xu, Ql, Qlf, Ql, Ql, Ql, Ql, Ql, Xu, Ql, Xu, Xu, Xu
Xu, Xu, Xu, Xu, Xu, Xu, Xu, Xu, Ds, Xu, Ds, Xu, Xu, Xu, Xu, Xu, Xu, Xu, Xu, Xu, Xu, Xu, Xu, Xu, Xu, Xu, Xu, Xu, Qlf, Qlf, Cud, Qlf, Ql, Ql, Exos, Ql, Urb, Urb, Urb, Urb, Urb, Ql, Urb, Ql, Ql, Xu
Xu, Xu, Xu, Xu, Xu, Xu, Ds, Ds, Ds, Ds, Wwf, Xu, Xu, Xu, Xu, Xu, Dd^Vdt, Xu, Xu, Xu, Xu, Xu, Xu, Xu, Xu, Xu, Xu, Qlf, Ql, Urb, Urb, Urb, Ql, Exos, Urb, Urb, Urb, Urb, Urb, Urb, Uu^Vud, Cud, Cud, Urb, Urb, Ql
Xu, Xu, Xu, Xu, Xu, Xu, Xu, Ww, Wwf, Wwf, Ww, Chw, Ww, Ww, Ww, Ds, Ww, Ds, Xu, Xu, Xu, Xu, Xu, Xu, Xu, Qlf, Qlf, Qlf, Ql, Urb, Uu^Vud, Ql, Exos, Exos, Urb, Urb, Urb, Urb, Urb, Urb, Cud, Kud, Uu^Vud, Urb, Urb, Urb
Xu, Xu, Xu, Xu, Xu, Xu, Ww, Ww, Ww, Ww, Ww, Ww, Ww, Wo, Chw, Ww, Wwf, Ds, Ds, Xu, Xu, Xu, Xu, Xu, Qlf, Qlf, Ql, Ql, Urb, Urb, Ql, Ql, Exos, Urb, Urb, Urb, Ql, Urb, Urb, Urb, Urb, Cud, Ql, Urb, Urb, Urb
Xu, Xu, Xu, Xu, Xu, Xu, Wwf, Wwf, Wwf, Wwf, Ww, Wwf, Wwf, Wwf, Wwf, Wwf, Ww, Wwf, Wwf, Xu, Xu, Xu, Xu, Xu, Qlf, Ql, Urb, Urb, Ql, Ql, Exos, Ql, Ql, Urb, Ql^Bs\, Ql^Bs\, Urb, Ql, Ql, Ql, Ql, Ql, Urb, Ql, Ql, Rb
Xu, Xu, Xu, Xu, Xu, Xu, Wwf, Wwf, Wwf, Ww, Xu, Xu, Xu, Wwf, Ww, Ww, Ww, Ww, Xu, Xu, Xu, Xu, Xu, Xu, Qlf, Ql, Urb, Ql, Exos, Exos, Urb, Urb, Urb, Ql, Ql, Urb, Urb, Urb, Urb, Urb, Urb, Urb, Urb, Urb, Urb, Ql
Xu, Xu, Xu, Xu, Ds, Ds, Wwf, Wo, Ww, Ww, Xu, Xu, Xu, Ww, Wwf, Ww, Ww^Vm, Wwf, Wwf, Xu, Xu, Xu, Xu, Qlf, Ql, Ql, Urb, Ql, Urb, Urb, Urb, Urb, Urb, Urb, Urb, Ql, Ql, Urb, Urb, Urb, Urb, Urb, Urb, Urb, Urb, Urb
Xu, Xu, Ds, Xu, Ww, Ww, Ww, Chw, Ww, Ww^Vm, Ds, Xu, Xu, Xu, Wwf, Ww, Wwf, Wwf, Ds, Xu, Xu, Xu, Xu, Qlf, Ql, Ql, Urb, Urb, Urb, Urb, Urb, Urb, Urb, Urb, Urb, Urb, Urb, Uu^Vud, Urb, Urb, Urb, Urb, Urb, Urb, Urb, Urb
Xu, Ds, Wwf, Ww, Ww^Vm, Ww, Wwf, Wwf, Wwf, Ww, Ds, Xu, Xu, Xu, Ww, Ww, Ww, Wwf, Ds, Ds, Xu, Xu, Xu, Qlf, Ql, Urb, Urb, Urb, Urb, Urb, Urb, Urb, Ql, Uu^Vud, Ql, Urb, Urb, Urb, Urb, Urb, Urb, Urb, Urb, Urb, Urb, Urb
Ww, Ww, Wwf, Ww, Wwf, Ww, Wwf, Wwf, Xu, Xu, Xu, Xu, Xu, Ww, Ww, Wwf, Wo, Ww, Ds, Xu, Xu, Xu, Xu, Qlf, Qlf, Cud, Cud, Urb, Ql, Urb, Ql, Ql, Ql, Ql, Ql, Ql, Urb, Urb, Urb, Urb, Urb, Urb, Urb, Urb, Urb, Urb
Wwf, Khw, Ww, Wo, Ww, Wwf, Xu, Xu, Xu, Xu, Ds, Xu, Ww, Ww^Vm, Wwf, Wwf, Wwf, Wwf, Xu, Xu, Xu, Xu, Xu, Xu, Qlf, Kud, Qlf, Qlf, Qlf, Qlf, Ql, Xu, Ql, Ql, Xu, Ql, Ql, Urb, Urb, Urb, Urb, Urb, Urb, Urb, Uu^Vud, Urb
Wwf, Wwf, Ww, Ww, Ds, Xu, Xu, Xu, Xu, Ds, Wwf, Wwf, Wwf, Wwf, Chw, Ww, Ww, Ww, Xu, Xu, Xu, Xu, Xu, Xu, Xu, Qlf, Xu, Xu, Xu, Xu, Xu, Ql, Ql, Ql, Ql, Ql, Qlf, Ql, Ql, Ql, Ql, Ql, Ql, Ql, Ql, Ql
Ww, Ww, Xu, Ds, Xu, Xu, Xu, Xu, Ww, Ww, Wwf, Ww, Wo, Chw, Khw, Wwf, Ww, Ww, Xu, Xu, Xu, Xu, Xu, Xu, Xu, Xu, Xu, Xu, Xu, Xu, Xu, Xu, Xu, Xu, Xu, Qlf, Xu, Qlf, Xu, Xu, Xu, Xu, Xu, Ql, Xu, Ql
Xu, Xu, Xu, Xu, Xu, Xu, Xu, Xu, Wwf, Wwf, Wwf, Ww, Ww, Ww, Wwf, Wwf, Xu, Ww, Xu, Xu, Xu, Xu, Xu, Xu, Xu, Xu, Xu, Xu, Xu, Xu, Xu, Xu, Xu, Xu, Xu, Xu, Xu, Xu, Xu, Xu, Xu, Xu, Xu, Xu, Xu, Xu
Xu, Xu, Xu, Xu, Xu, Xu, Xu, Xu, Wwf, Cv, Wwf, Wwf, Ww, Wwf, Wwf, Wwf, Xu, Xu, Xu, Xu, Xu, Xu, Xu, Xu, Xu, Xu, Xu, Xu, Xu, Xu, Xu, Xu, Xu, Xu, Xu, Xu, Xu, Xu, Xu, Xu, Xu, Xu, Xu, Xu, Xu, Xu
Xu, Xu, Xu, Xu, Xu, Xu, Xu, Xu, Xu, Wwf, Wwf, Ww^Vm, Xu, Ds, Ds, Ds, Xu, Xu, Xu, Xu, Xu, Xu, Xu, Xu, Xu, Xu, Xu, Xu, Xu, Xu, Xu, Xu, Xu, Xu, Xu, Xu, Xu, Xu, Xu, Xu, Xu, Xu, Xu, Xu, Xu, Xu
Xu, Xu, Xu, Xu, Xu, Xu, Xu, Xu, Xu, Xu, Xu, Xu, Xu, Xu, Xu, Xu, Xu, Xu, Xu, Xu, Xu, Xu, Xu, Xu, Xu, Xu, Xu, Xu, Xu, Xu, Gs, Xu, Xu, Xu, Ds, Xu, Hd, Xu, Hd, Xu, Ds, Xu, Ds, Xu, Ds, Xu
Dd, Xu, Dd, Xu, Xu, Xu, Xu, Xu, Mdd^Xm, Xu, Mdd^Xm, Xu, Xu, Xu, Hd, Xu, Hd, Xu, Xu, Xu, Ds, Xu, Ds, Xu, Rd, Dd, Rd, Dd, Dd, Dd, Dd, Gs, Gs, Ds, Ds, Hd, Hd, Hd, Hd, Hd, Hd, Hd, Dd^Vda, Rb^Dr, Ds, Ds
Dd, Dd, Ds, Dd, Dd, Ds, Dd, Ds, Ds, Mdd^Xm, Mdd, Mdd^Xm, Ds, Hd, Dd, Hd, Hd, Dd, Hd, Ds, Ds, Ds, Dd^Vdt, Rd, Rd, Rd, Dd, Rd, Rd, Dd, Dd, Dd, Dd, Dd, Dd, Dd, Dd, Hd, Hd, Dd, Dd, Hd, Dd, Ds, Gs, Ds
Rd, Dd, Dd, Dd, Ds, Dd, Ds, Dd, Dd, Dd, Mdd, Mdd, Dd, Dd^Vdt, Dd, Dd, Dd, Hd, Dd, Hd, Dd, Dd^Dc, Rd, Rd, Ds, Ds, Rb^Dr, Dd^Dc, Dd, Rd, Rd, Ds, Ds, Dd^Dc, Rb^Dr, Ds, Dd^Dc, Dd, Dd, Hd, Dd, Dd, Gs, Gs, Gs, Gs
Ds, Ce, Dd, Ds, Ds, Rb^Dr, Ds, Dd, Ds, Dd, Dd, Dd, Ds, Dd, Dd^Dc, Rb^Dr, Ds, Ds, Dd, Ds, Dd, Dd, Hd, Ds, Hd, Ds, Dd, Dd, Ds, Dd, Dd, Dd^Dc, Dd, Ds, Ds, Ds, Dd, Dd, Dd, Dd, Dd, Dd, Gs, Gs, Gs, Gs
Ds, Dd^Vda, Dd, Dd, Rd, Ds, Rd, Dd, Rd, Dd, Dd, Dd, Hd, Ds, Dd, Ds, Dd, Ds, Dd, Dd, Dd, Dd, Dd, Hd, Hd, Ds, Dd, Dd, Dd, Dd, Dd, Ds, Ds, Dd, Dd, Dd, Ds, Dd, Ds, Dd, Rd, Rd, Rd, Rb^Dr, Ds, Ds
Ds, Ds, Dd, Dd, Dd, Rd, Ds, Rd, Dd, Dd, Dd, Hd, Hd, Dd, Ds, Dd, Dd, Rd, Dd, Dd, Dd, Dd, Dd, Dd, Dd, Dd, Dd, Dd, Dd, Ds, Dd, Dd, Dd, Rd, Rd, Rd, Rd, Rd, Rd, Rd, Dd, Ds, Ds, Ke, Rd, Ds
Ds, Ds, Dd, Dd, Ds, Dd, Dd, Ds, Dd, Rb^Dr, Dd, Hd, Rd, Hd, Hd, Rb^Dr, Ds, Rd, Dd, Dd, Dd, Dd, Dd, Ds, Rb^Dr, Ds, Hd, Dd, Ds, Ds, Ds, Dd, Ds, Dd, Dd, Ds, Dd, Dd, Dd, Dd^Dc, Ds, Ds, Dd, Ds, Ds, Ds
Ds, Ds, Hd, Hd, Hd, Ds, Dd, Dd, Dd, Ds, Ds, Hd, Hd, Rd, Rd, Dd^Dc, Rd, Rd, Ww, Dd, Mdd, Ww, Ww, Gs, Gs, Dd, Hd, Ds, Dd^Dc, Dd^Vda, Dd, Rb^Dr, Ds, Ds, Dd, Ds, Dd, Ds, Rb^Dr, Dd, Dd, Dd, Dd, Dd, Ds, Ds
Ds, Hd, Ds, Dd, Dd, Hd, Hd, Dd, Hd, Dd, Dd, Dd, Dd, Hd, Gs, Rd, Ds, Ww, Mdd, Mdd, Mdd, Mdd, Mdd, Ww, Ww, Hhd, Hd, Hd, Hd, Dd, Dd, Dd, Dd, Dd, Dd, Dd, Ds, Ds, Ds, Ds, Gs, Dd, Gs, Dd, Ds, Ds
Ds, Ds, Ds, Ds, Ds, Ds, Ds, Hd, Hd, Ds, Ds, Dd, Ds, Gs, Ww, Ww, Hd, Mdd, Mdd, Mdd, Mdd, Mdd, Gs, Gs, Gs, Ww, Hd, Hd, Hd, Hd, Hd, Hd, Ds, Ds, Ds, Ds, Ds, Ds, Ds, Ds, Ds, Gs, Gs, Gs, Ds, Ds
