Xos, Xos, Xos, Xos, Xos, Xos, Xos, Xos, Xos, Xos, Xos, Xos, Xos, Xos, Xos, Xos, Xos, Xu, Xu, Xu, Xu, Xu, Xu, Xu, Uu, Uu, Uu, Uu, Uu, Rr, Rr, Rr, Xu, Xu, Xu, Xu, Xos, Xos, Sm^Qhu, Xos, Uu^Tf, Xos
Xos, Xos, Xos, Xos, Xos, Xos, Xos, Xos, Rr, Rr, Rr, Xos, Xos, Xos, Rr, Xos, Xos, Xos, Xos, Xu, Xu, Xu, Uu, Uu, Rr, Uu, Uu, Uu, Rr, Rr, Xu, Xu, Xu, Xu, Rrd, Uu^Tf, Sm^Qhu, Sm^Qhu, Sm^Qhu, Sm^Qhu, Uu^Tf, Xos
Xos, Xos, Xos, Xos, Xos, Xos, Cud, Rr, Rr, Rr, Rr, Rr, Rr, Rr, Uu, Rr, Rr, Xos, Xos, Xos, Xos, Uu, Rr, Rr, Rp, Rr, Rb^Dr, Rr, Xu, Xu, Xu, Xu, Rr, Rrd, Sm^Qhu, Sm^Qhu, Uu^Vud, Uu, Uu^Vud, Uu^Tf, Sm^Qhu, Xos
Xos, Xos, Xos, Xos, Uh, Rr, Rr, Rr, Cud, Rr, Rr, Rr, Uu, Uu, Xu, Uu^Vud, Rr, Rr, Rr, Xos, Xos, Rr, Rp, Rp, Rr, Rr, Rr^Pr/, Rr^Pr/, Cud, Xu, Urb, Rr, Uh, Sm^Qhu, Sm^Qhu, Rr, Urb, Urb, Sm^Qhu, Rrd, Rrd, Xos
Xos, Xos, Rr, Uu, Uh, Rr, Rr, Uu^Vud, Xu, Rr, Xu, Xu, Xu, Xu, Rr, Xu, Rr, Rr, Xos, Xos, Uu^Vud, Rp, Rp, Rp, Xu, Xu, Cud, Cud, Sm^Qhu, Urb, Sm^Qhu, Urb, Uh, Sm^Qhu, Rb^Dr, Rb^Dr, Sm^Qhu, Sm^Qhu, Urb, Sm^Qhu, Sm^Qhu, Xos
Xos, Rr, Rr, Rr, Rr, Rr, Xu, Xu, Rr, Xu, Rr, Rr, Rr, Rr, Rr, Rr, Xos, Xos, Uu, Uu, Rb^Dr, Rr, Rp, Rr, Rr, Xu, Xu, Rr, Rr, Sm^Qhu, Sm^Qhu, Uh, Urb, Uu^Tf, Uu^Tf, Sm^Qhu, Rr, Urb, Cud, Rr, Xos, Xos
Xos, Rr, Rr, Rr, Xu, Xu, Xos, Rr, Rr, Rb^Dr, Rr, Rr, Xos, Rr, Xos, Xos, Uu, Uu^Vud, Uh, Rr, Rr, Rr, Rr, Rr, Rr, Uu^Tf, Xos, Xu, Xu, Uu^Tf, Uu^Tf, Sm^Qhu, Urb, Urb, Urb, Sm^Qhu, Urb, Cud, 2 Kud, Cud, Xos, Xos
Xos, Rr, Rr, Rr, Xu, Xos, Rr, Xos, Xos, Rb^Dr, Rr, Uu, Uu, Xos, Xos, Uu, Uu, Rr, Uh, Uh, Rr, Rr, Rb^Dr, Rr, Uu^Tf, Uu^Tf, Xos, Rr, Rr, Xu, Xu, Uu^Vud, Uu, Sm^Qhu, Sm^Qhu, Urb, Sm^Qhu, Cud, Cud, Cud, Xos, Xos
Xos, Rr, Rr, Rr, Rr, Rr, Rr, Uu^Vud, Uu, Xos, Xos, Rr, Rr, Rr, Rr, Xos, Xos, Uu^Vud, Uu, Rr, Rr, Rr, Rr, Rr, Uu^Tf, Uu^Tf, Xos, Xos, Rr^Pr\, Xos, Xos, Xu, Xu, Uu^Vud, Rr, Sm^Qhu, Sm^Qhu, Sm^Qhu, Uu, Urb, Urb, Xos
Xos, Rr, Rr, Rr, Rr, Rr, Rr, Rr, Rr, Rr, Rr, Xos, Xos, Rr, Uu, Rb^Dr, Rr, Xos, Xos, Uu, Rr, Rr, Rr, Rr, Xos, Xos, Rr^Pr\, Rr, Xos, Xos, Rr, Rr, Rr, Xu, Xu, Sm^Qhu, Rr, Sm^Qhu, Uu^Tf, Uu^Vud, Sm^Qhu, Xos
Xos, Uu^Tf, Uu^Tf, Rr, Rr, Rr, Rr, Rr, Rr, Rr, Rr, Cud, Uu, Xos, Xos, Rr, Rr, Rr, Xos, Xos, Rr, Rr, Rr, Xu, Rr, Rr, Xos, Xos, Re, Uu^Tf, Rr, Rr, Rr, Rr, Rr, Xu, Xu, Rr, Uu^Vud, Sm^Qhu, Sm^Qhu, Xos
Xos, Xos, Xos, Uh, Uh, Rr, Xu, Rr, Cud, Rr, Rr, Rr, Rr, Uu, Xos, Rr, Rr, Rr, Xos, Xos, Uu, Rr, Uu, Xu, Xu, Rr, Rr, Xu, Xu, Uu^Tf, Rr, Rr, Rr, Rr, Rr, Rr, Rr, Xu, Xu, Xos, Xos, Xos
Xos, Xos, Xos, Xos, Xos, Xu, Xu, Xu, Xu, Rr, Rr, Rr, Rr, Uu, Xos, Rr, Rr, Rr, Xos, Xos, Uh, Rr, Uu, Xu, Xu, Xu, Xu, Rr, Xu, Xu, Rr, Rr, Xos, Rr, Rr, Rr, Rr, Rr, Rr, Xu, Xu, Xos
Xos, Xos, Xos, Xos, Xos, Xos, Xu, Xu, Uu^Vud, Uu, Rr, Rr, Uh, Uh, Xos, Rr, Rr, Rr, Xos, Xos, Uh, Rr, Rr, Rr, Rr, Rr, Cud, Xu, Xu, Rr, Rr, Rr, Rr, Xos, Xos, Rr, Rr, Rr, Rr, Uu^Vud, Xos, Xos
Xos, Xos, Xos, Xos, Xos, Xos, Uu, Uu, Rr, Rr, Rr, Rr, Xu, Xos, Rr, Rr, Rr, Rr, Xos, Xos, Rr, Uu^Tf, Rr, Rr, Cud, Rr, Rr, Uh, Xu, Rr, Rr, Rr, Rr, Rr, Xos, Rr, Rr, Rr, Rr, Uu, Xos, Xos
Xos, Xos, Xos, Xos, Xos, Xos, Uu, Rr, Rr, Rr, Xu, Xu, Rr, Rr, Rr, Rb^Dr, Xu, Xu, Xos, Xos, Uu^Tf, Rr, Rr, Rr, Xos, Rr, Rr, Uh, Rr, Rr, Uu, Rr, Xos, Xos, Rr, Cud, Rr, Rr, Rr, Uu, Xos, Xos
Xos, Xos, Xos, Xos, Xos, Rr, Rr, Rr, Rr, Rr, Xu, Rr, Cud, Rr, Cud, Xu, Xu, Xu, Xu, Xos, Rb^Dr, Uu^Tf, Xos, Xos, Rr, Xos, Xos, Rr, Rr, Uu, Xos, Xos, Uu^Vud, Rr, Rr, Rr, Rr, Cud, Xos, Xos, Xos, Xos
Xos, Xos, Xos, Xos, Xos, Rr, Rr, Rr, Rr, Rr, Rr^Vhc, Xu, Rr, Rr, Rr, Uu^Vud, Xu, Xu, Xu, Xu, Xu, Xos, Uu, Rr, Rr, Rr, Rr, Xos, Xos, Xos, Uu, Uu, Rr, Rr, Rr, Rr, Xos, Xos, Xos, Xos, Xos, Xos
Xos, Xos, Xos, Xos, Xos, Rr, Rr^Vhc, Rr, Cud, Rr, Rr, Xu, Rr, Rr, Rr, Uu, Uu^Vud, Xu, Uu, Cud, Rr, Uu, Rr, Uu, Uu, Uu, Rr, Rr, Rr, Rr, Uu, Uu, Rr, Rr, Xos, Xos, Xos, Xos, Xos, Xos, Xos, Xos
Xos, Xos, Xos, Xos, Xos, Xos, Rb^Dr, Cud, 1 Kud, Cud, Rr, Xos, Xos, Rr, Rb^Dr, Rr, Rr, Uh, Rr, Rr, Rr, Rr, Rr, Rr, Xos, Xos, Xos, Rb^Dr, Rb^Dr, Uu, Rr, Rr, Xos, Xos, Xos, Xos, Xos, Xos, Xos, Xos, Xos, Xos
Xos, Xos, Xos, Xos, Rr, Rr, Rb^Dr, Cud, Cud, Cud, Rr, Rr, Rr, Xos, Xos, Rb^Dr, Rr, Rr, Xos, Cud, Xos, Rr, Xos, Xos, Xos, Xos, Xos, Xos, Xos, Rr, Xos, Xos, Xos, Xos, Xos, Xos, Xos, Xos, Xos, Xos, Xos, Xos
Xos, Xos, Rr, Rr, Rr, Rr, Rr, Rb^Dr, Rr, Rr, Rr, Rr, Rr, Rr, Xos, Xos, Xos, Xos, Xos, Xos, Xos, Xos, Xos, Xos, Xos, Xos, Xos, Xos, Xos, Xos, Xos, Xos, Xos, Xos, Xos, Xos, Xos, Xos, Xos, Xos, Xos, Xos
