border_size=1
usage=map

Xos, Xos, Xos, Xos, Xos, Xos, Xos, Xos, Xos, Xos, Xos, Xos, Xos, Xos, Xos, Xos, Xos, Xu, Xu, Xu, Xu, Xu, Xu, Xu, Uu, Uu, Uu, Uu, Uu, Rr, Rr, Rr, Xu, Xu, Xu, Xu, Rr, Rr, Ss, Rr, Re^Uf, Rr
Xos, Xos, Xos, Xos, Xos, Xos, Xos, Xos, Rr, Rr, Rr, Xos, Xos, Xos, Rr, Xos, Xos, Xos, Xos, Xu, Xu, Xu, Uu, Uu, Rr, Uu, Uu, Uu, Rr, Rr, Xu, Xu, Xu, Xu, Ds, Re^Uf, Ss, Ss, Ss, Ss, Re^Uf, Rr
Xos, Xos, Xos, Xos, Xos, Xos, Cud, Rr, Rr, Rr, Rr, Rr, Rr, Rr, Uu, Rr, Rr, Xos, Xos, Xos, Xos, Uu, Rr, Rr, Rd, Rr, Dd^Dr, Rr, Xu, Xu, Xu, Xu, Rr, Ds, Ss, Ss, Uu^Vud, Uu, Uu^Vud, Re^Uf, Ss, Rr
Xos, Xos, Xos, Xos, Uh, Rr, Rr, Rr, Cud, Rr, Rr, Rr, Uu, Uu, Xu, Uu^Vud, Rr, Rr, Rr, Xos, Xos, Rr, Rd, Rd, Rr, Rr, Rr^Z/, Rr^Z/, Cud, Xu, Rd, Rr, Uh, Ss, Ss, Rr, Rd, Rd, Ss, Ds, Ds, Rr
Xos, Xos, Rr, Uu, Uh, Rr, Rr, Uu^Vud, Xu, Rr, Xu, Xu, Xu, Xu, Rr, Xu, Rr, Rr, Xos, Xos, Uu^Vud, Rr, Rd, Rr, Xu, Xu, Cud, Cud, Ss, Rd, Ss, Rd, Uh, Ss, Dd^Dr, Dd^Dr, Ss, Ss, Rd, Ss, Ss, Rr
Xos, Rr, Rr, Rr, Rr, Rr, Xu, Xu, Rr, Xu, Rr, Rr, Rr, Rr, Rr, Rr, Xos, Xos, Uu, Uu, Dd^Dr, Rr, Rd, Rr, Rr, Xu, Xu, Rr, Rr, Ss, Ss, Uh, Rr, Re^Uf, Re^Uf, Ss, Rr, Rd, Cud, Rr, Rr, Rr
Xos, Rr, Rr, Rr, Xu, Xu, Xos, Rr, Rr, Dd^Dr, Rr, Rr, Xos, Rr, Xos, Xos, Uu, Uu^Vud, Uh, Rr, Rr, Rr, Rr, Rr, Rr, Re^Uf, Xos, Xu, Xu, Dd^Dr, Re^Uf, Ss, Rr, Rd, Rd, Ss, Rd, Cud, 2 Kud, Cud, Rr, Rr
Xos, Rr, Rr, Rr, Xu, Xos, Rr, Xos, Xos, Dd^Dr, Rr, Uu, Uu, Xos, Xos, Uu, Uu, Rr, Uh, Uh, Rr, Rr, Dd^Dr, Rr, Re^Uf, Re^Uf, Xos, Rr, Rr, Xu, Xu, Uu^Vud, Uu, Ss, Ss, Rd, Ss, Cud, Cud, Cud, Rr, Rr
Xos, Rr, Rr, Rr, Rr, Rr, Rr, Uu^Vud, Uu, Xos, Xos, Rr, Rr, Rr, Rr, Xos, Xos, Uu^Vud, Uu, Rr, Rr, Rr, Rr, Rr, Re^Uf, Re^Uf, Xos, Xos, Rr^Z\, Xos, Xos, Xu, Xu, Uu^Vud, Rr, Ss, Ss, Ss, Uu, Rd, Rd, Rr
Xos, Rr, Rr, Rr, Rr, Rr, Rr, Rr, Rr, Rr, Rr, Xos, Xos, Rr, Uu, Dd^Dr, Rr, Xos, Xos, Uu, Rr, Rr, Rr, Rr, Xos, Xos, Rr^Z\, Rr, Xos, Xos, Rr, Rr, Rr, Xu, Xu, Ss, Rr, Ss, Re^Uf, Uu^Vud, Ss, Rd
Xos, Re^Uf, Re^Uf, Rr, Rr, Rr, Rr, Rr, Rr, Rr, Rr, Cud, Uu, Xos, Xos, Rr, Rr, Rr, Xos, Xos, Rr, Rr, Rr, Xu, Rr, Rr, Xos, Xos, Re, Re^Uf, Rr, Rr, Rr, Rr, Rr, Xu, Xu, Rr, Uu^Vud, Ss, Ss, Ss
Xos, Xos, Xos, Uh, Uh, Rr, Xu, Rr, Cud, Rr, Rr, Rr, Rr, Uu, Xos, Rr, Rr, Rr, Xos, Xos, Uu, Rr, Uu, Xu, Xu, Rr, Rr, Xu, Xu, Re^Uf, Rr, Rr, Rr, Rr, Rr, Rr, Rr, Xu, Xu, Rr, Rr, Rr
Xos, Xos, Xos, Xos, Xos, Xu, Xu, Xu, Xu, Rr, Rr, Rr, Rr, Uu, Xos, Rr, Rr, Rr, Xos, Xos, Uh, Rr, Uu, Xu, Xu, Xu, Xu, Rr, Xu, Xu, Rr, Rr, Xos, Rr, Rr, Rr, Rr, Rr, Rr, Xu, Xu, Rr
Xos, Xos, Xos, Xos, Xos, Xos, Xu, Xu, Uu^Vud, Uu, Rr, Rr, Uh, Uh, Xos, Rr, Rr, Rr, Xos, Xos, Uh, Rr, Rr, Rr, Rr, Rr, Cud, Xu, Xu, Rr, Rr, Rr, Rr, Xos, Xos, Rr, Rr, Rr, Rr, Uu^Vud, Xos, Rr
Xos, Xos, Xos, Xos, Xos, Xos, Uu, Uu, Rr, Rr, Rr, Rr, Xu, Xos, Rr, Rr, Rr, Rr, Xos, Xos, Rr, Re^Uf, Rr, Rr, Cud, Rr, Rr, Uh, Xu, Rr, Rr, Rr, Rr, Rr, Xos, Rr, Rr, Rr, Rr, Uu, Xos, Rr
Xos, Xos, Xos, Xos, Xos, Xos, Uu, Rr, Rr, Rr, Xu, Xu, Rr, Rr, Rr, Dd^Dr, Xu, Xu, Xos, Xos, Re^Uf, Rr, Rr, Rr, Xos, Rr, Rr, Uh, Rr, Rr, Uu, Rr, Xos, Xos, Rr, Cud, Rr, Rr, Rr, Uu, Xos, Xos
Xos, Xos, Xos, Xos, Xos, Rr, Rr, Rr, Rr, Rr, Xu, Rr, Cud, Rr, Cud, Xu, Xu, Xu, Xu, Xos, Dd^Dr, Re^Uf, Xos, Xos, Rr, Xos, Xos, Rr, Rr, Uu, Xos, Xos, Uu^Vud, Rr, Rr, Rr, Rr, Cud, Xos, Xos, Xos, Xos
Xos, Xos, Xos, Xos, Xos, Rr, Rr, Rr, Rr, Rr, Gg^Vc, Xu, Rr, Rr, Rr, Uu^Vud, Xu, Xu, Xu, Xu, Xu, Xos, Uu, Rr, Rr, Rr, Rr, Xos, Xos, Xos, Uu, Uu, Rr, Rr, Rr, Rr, Xos, Xos, Xos, Xos, Xos, Xos
Xos, Xos, Xos, Xos, Xos, Rr, Gg^Vc, Rr, Cud, Rr, Rr, Xu, Rr, Rr, Rr, Uu, Uu^Vud, Xu, Uu, Cud, Rr, Uu, Rr, Uu, Uu, Uu, Rr, Rr, Rr, Rr, Uu, Uu, Rr, Rr, Xos, Xos, Xos, Xos, Xos, Xos, Xos, Xos
Xos, Xos, Xos, Xos, Xos, Xos, Dd^Dr, Cud, 1 Kud, Cud, Rr, Xos, Xos, Rr, Dd^Dr, Rr, Rr, Uh, Rr, Rr, Rr, Rr, Rr, Rr, Xos, Xos, Xos, Dd^Dr, Dd^Dr, Uu, Rr, Rr, Xos, Xos, Xos, Xos, Xos, Xos, Xos, Xos, Xos, Xos
Xos, Xos, Xos, Xos, Rr, Rr, Dd^Dr, Cud, Cud, Cud, Rr, Rr, Rr, Xos, Xos, Dd^Dr, Rr, Rr, Xos, Cud, Xos, Rr, Xos, Xos, Xos, Xos, Xos, Xos, Xos, Rr, Xos, Xos, Xos, Xos, Xos, Xos, Xos, Xos, Xos, Xos, Xos, Xos
Xos, Xos, Rr, Rr, Rr, Rr, Rr, Dd^Dr, Rr, Rr, Rr, Rr, Rr, Rr, Xos, Xos, Xos, Xos, Xos, Xos, Xos, Xos, Xos, Xos, Xos, Xos, Xos, Xos, Xos, Xos, Xos, Xos, Xos, Xos, Xos, Xos, Xos, Xos, Xos, Xos, Xos, Xos
