Ww, Ww, Ww, Ww, Ww, Ww, Ww, Rrd, Gg, Gg, Gg, Gg, Gg, Rd, Gll^Fp, Rd, Re, Rd, Re, Gg, Gll^Fp, Gll^Fp, Gll^Fp, Gll^Fp, Gll^Fp, Gll^Fp, Gll^Fp, Gll^Fp, Gll^Fp, Gll^Fp, Gll^Fp, Gg, Gll^Fp, Gg, Gll^Fp
Ww, Ww, Ww, Ww, Ww, Ww, Rrd, Rrd, Gg, Gg, Gg, Gg, Gg, Rd, Re, Rd, Rd, Rd, Rd, Gs^Fms, Gs^Fms, Gs^Fp, Gs^Fp, Gs^Fp, Gs^Fp, Gs^Fp, Gs^Fp, Gs^Fp, Re, Re, Re^Tf, Gll^Fp, Gs^Fp, Gs^Fp, Gs^Fp
Ww, Ww, Ww, Ww, Ww, Ww, Rrd, Rd, Rd, Rd, Gg, Gs^Fms, Rd, Rd, Re, Re, Gs^Fp, Rb^Dr, Rd, Rd, Re, Gs^Fp, Gs^Fp, Gs^Fp, Gs^Fp, Gs^Fp, Gs^Fp, Gs^Fp, Rd, Re^Tf, Rd, Gs^Fp, Gs^Fp, Gs^Fp, Gg^Fet
Ww, Ww, Ww, Ww, Ww, Rrd, Rrd, Rd^Vdt, Re, Gg, Gs^Fms, Gs^Fms, Re, Re, Re, Gs^Fp, Gs^Fp, Gs^Fms, Gs^Fms, Rd, Rd, Gs^Fp, Gs^Fp, Gs^Fp, Rb^Dr, Cvr, Rd^Dr, Gg^Ve, Re^Tf, Re^Tf, Rd, Gs^Fp, Gs^Fp, Gs^Fp, Gs^Fp
Ww, Ww, Ww, Ww, Rrd, Rrd, Rd, Rd, Rb^Dr, Gg, Rd, Rd, Re, Re, Re, Gs^Fp, Gg^Ve, Gs^Fms, Gs^Fms, Gs^Fp, Gs^Fms, Rd, Rd, Rd, Cvr, 3 Kvr, Rd^Dr, Rd, Re^Tf, Re^Tf, Re, Gs^Fp, Gs^Fp, Gs^Fp, Gs^Fp
Ww, Ww, Ww, Ww, Rrd, Rrd, Re, Rd, Re, Rd, Gg^Fet, Re, Re, Gs^Fp, Gs^Fp, Gs^Fp, Gs^Fms, Gs^Fms, Gs^Fms, Gs^Fms, Gs^Fms, Gs^Fp, Gs^Fp, Rd, Rd, Rd^Dr, Gg, Gs^Fp, Gs^Fp, Rd, Cvr, Gs^Fp, Cvr, Gs^Fp, Gs^Fp
Ww, Ww, Ww, Ww, Rrd, Re, Rd, Rd, Gg, Rd, Gs^Fp, Re, Gs^Fp, Gs^Fp, Gs^Fp, Gs^Fp, Gs^Fms, Gs^Fms, Gs^Fms, Gs^Fms, Re, Gs^Fp, Gs^Fp, Gs^Fp, Gs^Fp, Gs^Fp, Gs^Fp, Gs^Fp, Cvr, Gs^Fp, Gs^Fp, Gg^Ve, Gs^Fp, Gs^Fp, Cvr
Ww, Ww, Ww, Ww, Ce, Rd, Gg, Rd, Gg, Rd, Re, Re, Gs^Fms, Gs^Fms, Gs^Fms, Gs^Fms, Gs^Fms, Gs^Fms, Gs^Fp, Re^Tf, Re^Tf, Re^Tf, Gs^Fp, Gs^Fp, Gs^Fp, Gs^Fp, Gs^Fp, Gs^Fp, Gs^Fp, Gg^Ve, Rb^Dr, Cvr, Cvr, Gg^Ve, Gs^Fp
Ww, Ww, Ww, Ce, 1 Ke, Ce, Gg, Rd, Gg, Re, Gs^Fp, Gs^Fms, Gs^Fp, Gs^Fms, Gs^Fms, Gs^Fp, Gs^Fms, Gs^Fms, Rd, Rd, Re^Tf, Re, Gs^Fp, Gs^Fp, Gs^Fp, Gs^Fp, Gs^Fp, Gs^Fp, Cvr, Gs^Fp, Cvr, Rb^Dr, Rb^Dr, Gs^Fp, Rb^Dr
Rd, Ww, Rrd, Ce, Ce, Ce, Gg, Rd, Rd^Vh, Gg, Re, Gs^Fp, Re, Gs^Fms, Gs^Fms, Gs^Fms, Re^Tf, Re^Tf, Rd, Gs^Fp, Gs^Fp, Gs^Fp, Gg^Ve, Gs^Fp, Gs^Fp, Gs^Fp, Gs^Fp, Gs^Fp, Gs^Fp, Gg^Ve, Gs^Fp, Rb^Dr, Gs^Fp, Gg^Ve, Gs^Fp
Re, Rrd, Rd, Rd, Rd, Gg, Rd, Rd, Rd, Re, Gs^Fms, Gs^Fms, Rb^Dr, Re, Gs^Fms, Gs^Fms, Rd, Re^Tf, Gs^Fp, Gs^Fp, Gs^Fp, Gs^Fp, Gs^Fp, Gs^Fp, Rd, Rd, Gs^Fp, Gs^Fp, Gs^Fp, Cvr, Gs^Fp, Gg^Ve, Gs^Fp, Cvr, Gs^Fp
Rd, Re, Rd, Gg, Rd, Rd, Rd, Rd, Re, Re, Gs^Fp, Gs^Fms, Re, Gs^Fp, Gs^Fms, Gs^Fp, Rd, Re^Tf, Re^Tf, Gs^Fp, Gs^Fp, Gs^Fp, Gs^Fp, Gs^Fp, Rd, Rd, Gs^Fp, Gs^Fp, Rd, Gs^Fp, Gs^Fp, Rb^Dr, Gs^Fp, Gs^Fp, Gs^Fp
Re, Re, Re, Rd, Rd, Rd, Rd, Re, Rd, Re, Gs^Fp, Gs^Fms, Re, Gs^Fp, Gs^Fms, Gs^Fp, Gs^Fp, Rd, Gs^Fp, Gs^Fp, Gs^Fms, Gs^Fms, Gs^Fms, Gs^Fp, Rd, Gs^Fp, Gs^Fp, Re^Tf, Re^Tf, Gs^Fp, Gs^Fp, Gs^Fp, Gs^Fp, Gs^Fp, Gs^Fp
Rd, Re, Gg, Gg, Re, Re, Rd, Rb^Dr, Rd, Re, Re, Gs^Fms, Gs^Fms, Gs^Fms, Gs^Fp, Gs^Fp, Gs^Fp, Gs^Fp, Gs^Fp, Gs^Fms, Re, Gs^Fp, Gs^Fms, Rd, Gs^Fp, Gs^Fp, Gs^Fms, Gs^Fp, Re^Tf, Rd, Rd, Gs^Fp, Gs^Fp, Gs^Fp, Gs^Fp
Rd, Re, Gg, Gg, Gg, Gg, Rd, Rd, Re, Rd, Rd, Rd, Gg^Fet, Gs^Fp, Gs^Fp, Gs^Fp, Rd, Rd, Gs^Fp, Re, Gs^Fp, Re, Gs^Fms, Gs^Fp, Gs^Fms, Gs^Fms, Gs^Fms, Rd, Rd, Re^Tf, Re^Tf, Gs^Fms, Gs^Fms, Gs^Fms, Gs^Fp
Re, Rd, Re, Gg, Rd, Rd, Re, Re, Re, Rd, Rd, Gs^Fp, Rd, Gs^Fp, Gs^Fp, Rd, Gs^Fp, Rd, Gll^Fp, Gs^Fms, Gs^Fms, Re, Rd, Gs^Fms, Re, Gs^Fp, Gs^Fms, Rd, Gs^Fp, Re^Tf, Re^Tf, Gs^Fp, Gs^Fp, Gs^Fms, Gs^Fms
Re, Re, Rd, Gg, Rd, Gg, Rd, Re, Gg, Re, Gg, Rd, Rd, Gs^Fp, Rd, Rd, Rd, Gs^Fp, Re^Tf, Rd, Rd, Rd, Rd, Rb^Dr, Re, Gs^Fms, Gs^Fms, Gg^Ve, Gs^Fp, Gs^Fp, Gs^Fp, Gs^Fms, Gs^Fms, Gs^Fms, Gs^Fms
Re, Rd, Rd, Rd, Rd^Vh, Rd, Rd, Re, Re, Re, Re, Rb^Dr, Rd, Rd, Rd, Gs^Fp, Rd, Gs^Fp, Rd, Re^Tf, Gs^Fp, Re, Rd, Rd, Gs^Fms, Re^Tf, Re, Gs^Fp, Gg^Ve, Gg^Fet, Gs^Fp, Gs^Fms, Gs^Fms, Gs^Fms, Gs^Fms
Re, Rd, Rd, Re, Rb^Dr, Rd, Rd, Rd, Re, Rd, Gg, Re, Re, Gs^Fp, Gs^Fp, Rb^Dr, Gs^Fp, Gs^Fp, Re^Tf, Re^Tf, Re, Re, Re, Gs^Fp, Re, Re^Tf, Re^Tf, Gs^Fp, Gs^Fp, Gs^Fp, Gs^Fp, Gs^Fms, Gs^Fms, Gs^Fms, Gs^Fp
Rd, Re, Re, Re, Rd, Re, Re, Gg, Re, Rd, Rd, Gg, Rd, Re, Gg^Vh, Gs^Fp, Gs^Fp, Gs^Fp, Rd, Re^Tf, Re^Tf, Gs^Fp, Gs^Fp, Gs^Fp, Gs^Fp, Re, Gs^Fp, Gs^Fp, Gs^Fp, Gs^Fp, Gs^Fp, Gs^Fp, Gs^Fp, Gs^Fp, Gs^Fp
Re, Rd, Re, Gg, Gg, Gg, Gs, Re, Gs^Fp, Rd, Re, Re, Gg, Gg, Rd, Rd, Re, Gs^Fp, Gs^Fp, Rd, Gs^Fp, Gs^Fp, Gs^Fms, Gs^Fp, Gs^Fms, Gs^Fp, Rd, Gs^Fp, Re, Gs^Fp, Gs^Fms, Gs^Fp, Gs^Fp, Gs^Fp, Gs^Fp
Re, Re, Gg, Gg, Gs^Fms, Gs^Fms, Gs^Fms, Gg, Hh, Hh, Hh, Hh, Gs^Fp, Gs^Fp, Hh, Rd, Gs^Fp, Re, Re, Gs^Fp, Rd, Gs^Fp, Re, Re, Rd, Gs^Fp, Rd, Re, Gs^Fp, Gs^Fp, Rd, Gs^Fms, Gs^Fms, Gs^Fp, Re
Re, Rd, Gg, Gg, Gs^Fms, Gs^Fms, Gs^Fp, Gs^Fms, Gs^Fms, Gs^Fms, Gs^Fms, Gs^Fms, Rd, Gs^Fp, Hh, Hh, Hh, Gs^Fp, Gs^Fp, Rd, Gs^Fp, Re, Gs^Fp, Gs^Fp, Re^Tf, Gs^Fp, Re, Gg^Ve, Gs^Fp, Re, Re, Gs^Fms, Gs^Fp, Gs^Fp, Rd
Rd, Rd, Gs^Fms, Gs^Fms, Re^Dr, Gs^Fp, Re, Gs^Fp, Gs^Fms, Gs^Fp, Re, Rd, Gs^Fp, Re, Re, Hh, Hh, Gs^Fms, Gs^Fms, Gs^Fp, Gs^Fp, Gs^Fp, Gs^Fp, Re^Tf, Rd, Re, Gs^Fp, Gs^Fp, Gs^Fp, Gs^Fp, Gs^Fp, Gs^Fp, Gs^Fp, Rd, Re
Gs^Fms, Gs^Fms, Gs^Fms, Gs^Fms, Gs^Fp, Gs^Fp, Gs^Fms, Gs^Fms, Gs^Fp, Re, Gs^Fp, Rd, Ww, Ww^Bw|, Ww, Hh, Ww, Gs^Fp, Gs^Fp, Gs^Fp, Cvr, Gs^Fp, Gs^Fp, Gs^Fp, Gs^Fms, Gs^Fms, Gs^Fp, Rd, Gs^Fp, Gs^Fp, Rd, Gs^Fp, Rd, Rd, Re
Gs^Fms, Gs^Fms, Gs^Fp, Gs^Fp, Ww, Ww, Ww, Ww, Ww, Ww, Ww, Ww, Gs^Fp, Ww^Bw|, Re, Ww, Ww, Cvr, Gs^Fp, Gs^Fp, Rb^Tf, Ww, Ww, Ww, Ww, Gs^Fms, Gs^Fp, Rd, Rd^Tf, Gs^Fp, Gs^Fp, Gs^Fp, Re, Gs^Fp, Gg
Gg, Gg, Ww, Ww, Gs^Fp, Gs^Fp, Gs^Fp, Gs^Fp, Gs^Fp, Gs^Fp, Gs^Fp, Gs^Fp, Rb^Dr, Gs^Fp, Gs^Fp, Gs^Fp, Gg^Ve, Re, Re, Gs^Fp, Re^Tf, Re^Tf, Gll^Fdw, Ww, Gg, Ww, Ww, Gs^Fp, Rb^Dr, Rd, Gs^Fp, Gs^Fp, Gs^Fp, Gs^Fp, Re
Ww, Ww, Ww, Gs^Fp, Re, Gs^Fp, Rd, Re, Re, Rd, Rd, Gs^Fp, Gg, Gs^Fp, Re^Tf, Rb^Dr, Rd, Gs^Fp, Re, Gs^Fp, Gll^Fdw, Gs^Fp, Gll^Fdw, Gs^Fms, Gs^Fp, Rb^Tf, Rb^Tf, Ww, Ww, Ww, Ww, Gs^Fp, Gs^Fp, Rd, Ww
Ww, Ww, Rd, Rd, Re, Gs^Fp, Re^Tf, Gs^Fp, Rd, Gs^Fp, Re, Gs^Fp, Gs^Fp, Gs^Fp, Re, Re^Tf, Gll^Fdw, Rd, Re, Re, Gs^Fp, Gll^Fdw, Gs^Fp, Gll^Fdw, Rd, Rb^Tf, Gs^Fp, Re, Gs^Fp, Rd, Gs^Fp, Ww, Ww, Ww, Gll^Fdw
Gg, Gg, Gs^Fp, Gs^Fp, Rd, Gs^Fp, Gs^Fp, Rb^Tf, Rb^Tf, Gs^Fp, Re, Re, Cvr, Hh, Hh, Gll^Fdw, Gs^Fp, Rd, Rd, Re, Gll^Fdw, Re, Re, Re, Rb^Tf, Rb^Tf, Hh, Hh, Re, Re, Re^Tf, Re, Rd, Re, Gll^Fdw
Gg, Gs^Fp, Rd, Gll^Fp, Rd, Gs^Fp, Rb^Tf, Rb^Tf, Rb^Tf, Gs^Fp, Rd, Cvr, 4 Kvr, Cvr, Hh, Gs^Fms, Re^Tf, Gll^Fdw, Gll^Fdw, Rd, Hh, Rb^Dr, Gs^Fp, Rd, Rb^Tf, Rb^Tf, Gll^Fdw, Gs^Fp, Rd, Gll^Fdw, Re^Tf, Gll^Fdw, Rd, Re, Rd
Gg, Gs^Fp, Gll^Fp, Gll^Fp, Gll^Fp, Gs^Fp, Rb^Tf, Re, Re, Gs^Fp, Re, Gs^Fp, Re, Gs^Fp, Hh, Re^Tf, Gs^Fp, Rd, Gs^Fp, Gs^Fp, Gs^Fp, Rd, Rd, Gll^Fdw, Gs^Fp, Rb^Tf, Re, Re, Gs^Fp, Rd, Rd, Re^Tf, Gs^Fp, Gll^Fdw, Gll^Fdw
Gg, Gll^Fp, Gg^Fet, Gg^Fet, Gg^Fet, Gll^Fp, Gs^Fp, Gs^Fp, Re, Rd, Gll^Fdw, Re, Re, Hh, Gs^Fp, Re, Gs^Fp, Rd^Ve, Gll^Fdw, Gll^Fdw, Re, Re, Rd, Re, Re, Gll^Fdw, Rd, Gll^Fdw, Re, Gg^Ve, Re, Rd, Rd, Gll^Fdw, Gll^Fdw
Gg, Gll^Fp, Gg^Fet, Gg^Fet, Gg^Fet, Gs^Fp, Rd, Gs^Fp, Rd, Gll^Fdw, Rd, Gll^Fdw, Re, Gll^Fdw, Gll^Fdw, Re, Gs^Fp, Gs^Fp, Gll^Fdw, Re, Gs^Fp, Re, Rb^Tf, Rb^Tf, Re, Gs^Fp, Re, Gs^Fp, Re, Gs^Fp, Rd, Re, Gs^Fp, Re, Gll^Fdw
Gg, Gll^Fp, Gs^Fp, Gg^Fet, Gll^Fp, Gll^Fp, Rd, Gll^Fdw, Gs^Fp, Rb^Dr, Re^Tf, Gs^Fp, Re, Re, Gll^Fdw, Gll^Fdw, Gs^Fp, Re^Tf, Gll^Fdw, Hh, Hh, Re, Re, Rb^Tf, Re, Rb^Dr, Gll^Fdw, Gll^Fdw, Re, Rd, Rd, Re, Re, Re, Re
Gg, Gll^Fp, Gs^Fp, Gs^Fp, Gs^Fp, Gg^Ve, Gs^Fp, Gs^Fp, Re, Re^Tf, Gs^Fp, Gll^Fdw, Gs^Fp, Gs^Fp, Rb^Dr, Re, Gll^Fdw, Rb^Tf, Rd, Gll^Fdw, Gs^Fp, Hh, Gll^Fdw, Re, Gll^Fdw, Rd, Gll^Fdw, Re, Gll^Fdw, Re, Gll^Fdw, Re, Re, Re, Rd
Gg, Gs^Fp, Re^Tf, Gs^Fp, Rd, Gs^Fp, Gs^Fp, Rd, Gs^Fp, Gs^Fp, Re, Gll^Fdw, Re, Rd, Rd, Gs^Fp, Rb^Tf, Rb^Tf, Rb^Tf, Rd, Hh, Hh, Gs^Fp, Re, Gll^Fdw, Gll^Fdw, Cvr, Cvr, Cvr, Gll^Fdw, Gll^Fdw, Gll^Fdw, Gll^Fdw, Gll^Fdw, Gs^Fp
Gg, Rd, Re^Tf, Re^Tf, Gs^Fp, Re, Rd, Gs^Fp, Gs^Fp, Rd, Gll^Fdw, Gs^Fp, Gll^Fdw, Gs^Fp, Re, Gll^Fdw, Gs^Fp, Rb^Tf, Gll^Fdw, Gs^Fp, Hh, Gs^Fp, Re, Gll^Fdw, Gll^Fdw, Re, Cvr, 2 Kvr, Cvr, Gll^Fdw, Gll^Fdw, Gll^Fdw, Gll^Fdw, Gs^Fp, Gs^Fp
Gs^Fp, Rd, Gs^Fp, Rd, Gs^Fp, Gs^Fp, Gs^Fp, Gs^Fp, Re, Rd, Gs^Fp, Gs^Fp, Rd, Re, Re, Rd, Gll^Fdw, Re, Gs^Fp, Gs^Fp, Gs^Fp, Gg^Ve, Gs^Fp, Gll^Fdw, Gll^Fdw, Re, Re, Cvr, Cvr, Gll^Fdw, Gll^Fdw, Gll^Fdw, Gll^Fdw, Gs^Fp, Re
Gs^Fp, Gs^Fp, Gg, Gs^Fp, Re, Re, Rd, Re, Gs^Fp, Re, Re, Rd, Re, Gs^Fp, Gll^Fdw, Rd, Re, Gs^Fp, Rb^Dr, Gll^Fdw, Gs^Fp, Gs^Fp, Re, Gs^Fp, Gll^Fdw, Gll^Fdw, Re, Gll^Fdw, Gll^Fdw, Gll^Fdw, Re, Gll^Fdw, Gs^Fp, Re, Re
Gg, Gg, Gg, Gg, Gg, Rd, Gg, Gs^Fp, Gg, Gs^Fp, Gg, Gll^Fdw, Gg, Gll^Fdw, Gs^Fp, Gs^Fp, Gg, Gll^Fdw, Gs^Fp, Gll^Fdw, Gg, Gs^Fp, Gs^Fp, Rd, Gs^Fp, Gg, Re, Rd, Gg, Gll^Fdw, Gg, Re, Gg, Rd, Rd
